"BA Code","Timestamp (Hour Ending)","Demand (MWh)","Demand Forecast (MWh)","Net Generation (MWh)","Total Interchange (MWh)"
SCL,"10/1/2024 12 a.m. PDT",868,850,769,-99
SCL,"10/1/2024 1 a.m. PDT",820,774,796,-24
SCL,"10/1/2024 2 a.m. PDT",783,744,798,15
SCL,"10/1/2024 3 a.m. PDT",772,729,790,18
SCL,"10/1/2024 4 a.m. PDT",765,731,787,22
SCL,"10/1/2024 5 a.m. PDT",796,759,798,2
SCL,"10/1/2024 6 a.m. PDT",867,836,785,-82
SCL,"10/1/2024 7 a.m. PDT",991,967,765,-226
SCL,"10/1/2024 8 a.m. PDT",1089,1064,220,-869
SCL,"10/1/2024 9 a.m. PDT",1109,1078,170,-939
SCL,"10/1/2024 10 a.m. PDT",1094,1062,141,-953
SCL,"10/1/2024 11 a.m. PDT",1095,1042,117,-978
SCL,"10/1/2024 12 p.m. PDT",1088,1030,125,-963
SCL,"10/1/2024 1 p.m. PDT",1076,1021,119,-957
SCL,"10/1/2024 2 p.m. PDT",1091,1015,189,-902
SCL,"10/1/2024 3 p.m. PDT",1065,1010,179,-886
SCL,"10/1/2024 4 p.m. PDT",1062,1005,143,-919
SCL,"10/1/2024 5 p.m. PDT",1082,1015,160,-922
SCL,"10/1/2024 6 p.m. PDT",1098,1028,156,-942
SCL,"10/1/2024 7 p.m. PDT",1077,1041,172,-905
SCL,"10/1/2024 8 p.m. PDT",1080,1061,167,-913
SCL,"10/1/2024 9 p.m. PDT",1042,1030,753,-289
SCL,"10/1/2024 10 p.m. PDT",979,978,770,-209
SCL,"10/1/2024 11 p.m. PDT",941,906,886,-55
SCL,"10/2/2024 12 a.m. PDT",866,837,811,-55
SCL,"10/2/2024 1 a.m. PDT",817,777,786,-31
SCL,"10/2/2024 2 a.m. PDT",789,739,781,-8
SCL,"10/2/2024 3 a.m. PDT",761,723,778,17
SCL,"10/2/2024 4 a.m. PDT",751,723,783,32
SCL,"10/2/2024 5 a.m. PDT",736,751,769,33
SCL,"10/2/2024 6 a.m. PDT",799,828,766,-33
SCL,"10/2/2024 7 a.m. PDT",927,959,728,-199
SCL,"10/2/2024 8 a.m. PDT",1006,1064,212,-794
SCL,"10/2/2024 9 a.m. PDT",1037,1083,200,-837
SCL,"10/2/2024 10 a.m. PDT",1033,1073,157,-876
SCL,"10/2/2024 11 a.m. PDT",1016,1063,189,-827
SCL,"10/2/2024 12 p.m. PDT",1009,1050,211,-798
SCL,"10/2/2024 1 p.m. PDT",1008,1043,168,-840
SCL,"10/2/2024 2 p.m. PDT",1005,1039,127,-878
SCL,"10/2/2024 3 p.m. PDT",988,1032,144,-844
SCL,"10/2/2024 4 p.m. PDT",990,1034,150,-840
SCL,"10/2/2024 5 p.m. PDT",1002,1045,112,-890
SCL,"10/2/2024 6 p.m. PDT",1020,1057,182,-838
SCL,"10/2/2024 7 p.m. PDT",1022,1066,199,-823
SCL,"10/2/2024 8 p.m. PDT",1035,1083,188,-847
SCL,"10/2/2024 9 p.m. PDT",1013,1057,818,-195
SCL,"10/2/2024 10 p.m. PDT",958,1011,823,-135
SCL,"10/2/2024 11 p.m. PDT",889,944,873,-16
SCL,"10/3/2024 12 a.m. PDT",824,875,811,-13
SCL,"10/3/2024 1 a.m. PDT",774,782,798,24
SCL,"10/3/2024 2 a.m. PDT",742,747,788,46
SCL,"10/3/2024 3 a.m. PDT",731,732,788,57
SCL,"10/3/2024 4 a.m. PDT",726,734,788,62
SCL,"10/3/2024 5 a.m. PDT",757,762,767,10
SCL,"10/3/2024 6 a.m. PDT",833,840,755,-78
SCL,"10/3/2024 7 a.m. PDT",958,974,209,-749
SCL,"10/3/2024 8 a.m. PDT",1062,1087,158,-904
SCL,"10/3/2024 9 a.m. PDT",1068,1099,164,-904
SCL,"10/3/2024 10 a.m. PDT",1057,1082,163,-894
SCL,"10/3/2024 11 a.m. PDT",1039,1060,165,-874
SCL,"10/3/2024 12 p.m. PDT",1023,1037,156,-867
SCL,"10/3/2024 1 p.m. PDT",1014,1024,168,-846
SCL,"10/3/2024 2 p.m. PDT",1002,1015,234,-768
SCL,"10/3/2024 3 p.m. PDT",996,1004,227,-769
SCL,"10/3/2024 4 p.m. PDT",994,1004,181,-813
SCL,"10/3/2024 5 p.m. PDT",1007,1025,198,-809
SCL,"10/3/2024 6 p.m. PDT",1019,1035,201,-818
SCL,"10/3/2024 7 p.m. PDT",1021,1043,219,-802
SCL,"10/3/2024 8 p.m. PDT",1030,1059,812,-218
SCL,"10/3/2024 9 p.m. PDT",1009,1029,870,-139
SCL,"10/3/2024 10 p.m. PDT",960,985,762,-198
SCL,"10/3/2024 11 p.m. PDT",894,917,898,4
SCL,"10/4/2024 12 a.m. PDT",829,856,745,-84
SCL,"10/4/2024 1 a.m. PDT",778,782,623,-155
SCL,"10/4/2024 2 a.m. PDT",741,748,653,-88
SCL,"10/4/2024 3 a.m. PDT",725,730,802,77
SCL,"10/4/2024 4 a.m. PDT",725,730,793,68
SCL,"10/4/2024 5 a.m. PDT",741,757,792,51
SCL,"10/4/2024 6 a.m. PDT",804,832,782,-22
SCL,"10/4/2024 7 a.m. PDT",916,955,197,-719
SCL,"10/4/2024 8 a.m. PDT",1023,1058,179,-844
SCL,"10/4/2024 9 a.m. PDT",1111,1085,209,-902
SCL,"10/4/2024 10 a.m. PDT",1129,1087,126,-1003
SCL,"10/4/2024 11 a.m. PDT",1160,1079,110,-1050
SCL,"10/4/2024 12 p.m. PDT",1150,1064,101,-1049
SCL,"10/4/2024 1 p.m. PDT",1143,1052,104,-1039
SCL,"10/4/2024 2 p.m. PDT",1122,1034,100,-1022
SCL,"10/4/2024 3 p.m. PDT",1096,1020,106,-990
SCL,"10/4/2024 4 p.m. PDT",1073,1018,105,-968
SCL,"10/4/2024 5 p.m. PDT",1081,1028,235,-846
SCL,"10/4/2024 6 p.m. PDT",1088,1033,247,-841
SCL,"10/4/2024 7 p.m. PDT",1083,1033,284,-799
SCL,"10/4/2024 8 p.m. PDT",1075,1038,725,-350
SCL,"10/4/2024 9 p.m. PDT",1049,1007,797,-252
SCL,"10/4/2024 10 p.m. PDT",1015,972,806,-209
SCL,"10/4/2024 11 p.m. PDT",961,924,834,-127
SCL,"10/5/2024 12 a.m. PDT",900,870,797,-103
SCL,"10/5/2024 1 a.m. PDT",833,821,805,-28
SCL,"10/5/2024 2 a.m. PDT",821,777,803,-18
SCL,"10/5/2024 3 a.m. PDT",792,756,796,4
SCL,"10/5/2024 4 a.m. PDT",782,748,789,7
SCL,"10/5/2024 5 a.m. PDT",792,758,771,-21
SCL,"10/5/2024 6 a.m. PDT",810,789,655,-155
SCL,"10/5/2024 7 a.m. PDT",865,844,167,-698
SCL,"10/5/2024 8 a.m. PDT",930,896,209,-721
SCL,"10/5/2024 9 a.m. PDT",978,945,174,-804
SCL,"10/5/2024 10 a.m. PDT",1005,975,109,-896
SCL,"10/5/2024 11 a.m. PDT",1020,984,101,-919
SCL,"10/5/2024 12 p.m. PDT",1026,979,95,-931
SCL,"10/5/2024 1 p.m. PDT",1010,969,95,-915
SCL,"10/5/2024 2 p.m. PDT",996,962,93,-903
SCL,"10/5/2024 3 p.m. PDT",984,959,116,-868
SCL,"10/5/2024 4 p.m. PDT",962,958,190,-772
SCL,"10/5/2024 5 p.m. PDT",964,969,237,-727
SCL,"10/5/2024 6 p.m. PDT",987,979,262,-725
SCL,"10/5/2024 7 p.m. PDT",1011,999,272,-739
SCL,"10/5/2024 8 p.m. PDT",1002,1015,801,-201
SCL,"10/5/2024 9 p.m. PDT",1011,992,848,-163
SCL,"10/5/2024 10 p.m. PDT",1002,956,825,-177
SCL,"10/5/2024 11 p.m. PDT",940,918,811,-129
SCL,"10/6/2024 12 a.m. PDT",886,874,791,-95
SCL,"10/6/2024 1 a.m. PDT",837,802,642,-195
SCL,"10/6/2024 2 a.m. PDT",814,761,548,-266
SCL,"10/6/2024 3 a.m. PDT",783,741,546,-237
SCL,"10/6/2024 4 a.m. PDT",774,735,542,-232
SCL,"10/6/2024 5 a.m. PDT",783,742,494,-289
SCL,"10/6/2024 6 a.m. PDT",806,772,527,-279
SCL,"10/6/2024 7 a.m. PDT",847,822,659,-188
SCL,"10/6/2024 8 a.m. PDT",901,873,723,-178
SCL,"10/6/2024 9 a.m. PDT",962,914,748,-214
SCL,"10/6/2024 10 a.m. PDT",991,939,568,-423
SCL,"10/6/2024 11 a.m. PDT",990,952,510,-480
SCL,"10/6/2024 12 p.m. PDT",981,957,591,-390
SCL,"10/6/2024 1 p.m. PDT",983,954,599,-384
SCL,"10/6/2024 2 p.m. PDT",970,954,587,-383
SCL,"10/6/2024 3 p.m. PDT",975,953,600,-375
SCL,"10/6/2024 4 p.m. PDT",977,957,836,-141
SCL,"10/6/2024 5 p.m. PDT",988,975,945,-43
SCL,"10/6/2024 6 p.m. PDT",1025,1001,973,-52
SCL,"10/6/2024 7 p.m. PDT",1058,1025,961,-97
SCL,"10/6/2024 8 p.m. PDT",1082,1038,936,-146
SCL,"10/6/2024 9 p.m. PDT",1052,1016,894,-158
SCL,"10/6/2024 10 p.m. PDT",997,965,616,-381
SCL,"10/6/2024 11 p.m. PDT",932,901,431,-501
SCL,"10/7/2024 12 a.m. PDT",864,836,403,-461
SCL,"10/7/2024 1 a.m. PDT",814,783,565,-249
SCL,"10/7/2024 2 a.m. PDT",784,744,463,-321
SCL,"10/7/2024 3 a.m. PDT",764,730,464,-300
SCL,"10/7/2024 4 a.m. PDT",773,732,445,-328
SCL,"10/7/2024 5 a.m. PDT",795,760,444,-351
SCL,"10/7/2024 6 a.m. PDT",860,835,445,-415
SCL,"10/7/2024 7 a.m. PDT",985,964,223,-762
SCL,"10/7/2024 8 a.m. PDT",1080,1067,293,-787
SCL,"10/7/2024 9 a.m. PDT",1059,1090,285,-774
SCL,"10/7/2024 10 a.m. PDT",1044,1080,139,-905
SCL,"10/7/2024 11 a.m. PDT",1054,1070,114,-940
SCL,"10/7/2024 12 p.m. PDT",1079,1067,114,-965
SCL,"10/7/2024 1 p.m. PDT",1086,1064,100,-986
SCL,"10/7/2024 2 p.m. PDT",1088,1064,110,-978
SCL,"10/7/2024 3 p.m. PDT",1083,1066,136,-947
SCL,"10/7/2024 4 p.m. PDT",1096,1069,167,-929
SCL,"10/7/2024 5 p.m. PDT",1098,1091,193,-905
SCL,"10/7/2024 6 p.m. PDT",1104,1104,246,-858
SCL,"10/7/2024 7 p.m. PDT",1092,1095,245,-847
SCL,"10/7/2024 8 p.m. PDT",1108,1087,770,-338
SCL,"10/7/2024 9 p.m. PDT",1065,1045,775,-290
SCL,"10/7/2024 10 p.m. PDT",1010,989,614,-396
SCL,"10/7/2024 11 p.m. PDT",940,919,661,-279
SCL,"10/8/2024 12 a.m. PDT",863,843,660,-203
SCL,"10/8/2024 1 a.m. PDT",814,778,633,-181
SCL,"10/8/2024 2 a.m. PDT",774,738,647,-127
SCL,"10/8/2024 3 a.m. PDT",757,718,622,-135
SCL,"10/8/2024 4 a.m. PDT",754,715,623,-131
SCL,"10/8/2024 5 a.m. PDT",767,738,609,-158
SCL,"10/8/2024 6 a.m. PDT",822,805,666,-156
SCL,"10/8/2024 7 a.m. PDT",942,924,210,-732
SCL,"10/8/2024 8 a.m. PDT",1029,1026,236,-793
SCL,"10/8/2024 9 a.m. PDT",1066,1050,221,-845
SCL,"10/8/2024 10 a.m. PDT",1082,1050,115,-967
SCL,"10/8/2024 11 a.m. PDT",1066,1045,107,-959
SCL,"10/8/2024 12 p.m. PDT",1079,1040,100,-979
SCL,"10/8/2024 1 p.m. PDT",1096,1038,98,-998
SCL,"10/8/2024 2 p.m. PDT",1087,1034,94,-993
SCL,"10/8/2024 3 p.m. PDT",1073,1032,96,-977
SCL,"10/8/2024 4 p.m. PDT",1072,1036,95,-977
SCL,"10/8/2024 5 p.m. PDT",1045,1052,189,-856
SCL,"10/8/2024 6 p.m. PDT",1080,1065,217,-863
SCL,"10/8/2024 7 p.m. PDT",1060,1071,243,-817
SCL,"10/8/2024 8 p.m. PDT",1068,1070,534,-534
SCL,"10/8/2024 9 p.m. PDT",1027,1038,693,-334
SCL,"10/8/2024 10 p.m. PDT",978,987,692,-286
SCL,"10/8/2024 11 p.m. PDT",897,914,687,-210
SCL,"10/9/2024 12 a.m. PDT",823,845,679,-144
SCL,"10/9/2024 1 a.m. PDT",773,776,752,-21
SCL,"10/9/2024 2 a.m. PDT",737,741,718,-19
SCL,"10/9/2024 3 a.m. PDT",713,723,722,9
SCL,"10/9/2024 4 a.m. PDT",706,720,614,-92
SCL,"10/9/2024 5 a.m. PDT",716,740,625,-91
SCL,"10/9/2024 6 a.m. PDT",781,806,594,-187
SCL,"10/9/2024 7 a.m. PDT",898,924,277,-621
SCL,"10/9/2024 8 a.m. PDT",989,1027,246,-743
SCL,"10/9/2024 9 a.m. PDT",1014,1052,200,-814
SCL,"10/9/2024 10 a.m. PDT",1016,1051,109,-907
SCL,"10/9/2024 11 a.m. PDT",1006,1045,101,-905
SCL,"10/9/2024 12 p.m. PDT",1004,1040,99,-905
SCL,"10/9/2024 1 p.m. PDT",1012,1037,92,-920
SCL,"10/9/2024 2 p.m. PDT",1000,1033,98,-902
SCL,"10/9/2024 3 p.m. PDT",989,1026,98,-891
SCL,"10/9/2024 4 p.m. PDT",992,1029,96,-896
SCL,"10/9/2024 5 p.m. PDT",1003,1040,129,-874
SCL,"10/9/2024 6 p.m. PDT",1030,1057,174,-856
SCL,"10/9/2024 7 p.m. PDT",1030,1068,282,-748
SCL,"10/9/2024 8 p.m. PDT",1046,1072,775,-271
SCL,"10/9/2024 9 p.m. PDT",1011,1038,808,-203
SCL,"10/9/2024 10 p.m. PDT",966,992,778,-188
SCL,"10/9/2024 11 p.m. PDT",889,926,658,-231
SCL,"10/10/2024 12 a.m. PDT",824,851,651,-173
SCL,"10/10/2024 1 a.m. PDT",776,779,765,-11
SCL,"10/10/2024 2 a.m. PDT",736,749,625,-111
SCL,"10/10/2024 3 a.m. PDT",717,734,614,-103
SCL,"10/10/2024 4 a.m. PDT",715,734,603,-112
SCL,"10/10/2024 5 a.m. PDT",739,762,616,-123
SCL,"10/10/2024 6 a.m. PDT",808,833,623,-185
SCL,"10/10/2024 7 a.m. PDT",926,956,507,-419
SCL,"10/10/2024 8 a.m. PDT",1033,1059,640,-393
SCL,"10/10/2024 9 a.m. PDT",1066,1093,633,-433
SCL,"10/10/2024 10 a.m. PDT",1091,1095,557,-534
SCL,"10/10/2024 11 a.m. PDT",1095,1087,163,-932
SCL,"10/10/2024 12 p.m. PDT",1099,1076,112,-987
SCL,"10/10/2024 1 p.m. PDT",1073,1072,108,-965
SCL,"10/10/2024 2 p.m. PDT",1043,1063,104,-939
SCL,"10/10/2024 3 p.m. PDT",1020,1052,101,-919
SCL,"10/10/2024 4 p.m. PDT",1006,1049,143,-863
SCL,"10/10/2024 5 p.m. PDT",1015,1061,153,-862
SCL,"10/10/2024 6 p.m. PDT",1034,1077,258,-776
SCL,"10/10/2024 7 p.m. PDT",1040,1087,297,-743
SCL,"10/10/2024 8 p.m. PDT",1042,1087,1008,-34
SCL,"10/10/2024 9 p.m. PDT",1025,1056,1039,14
SCL,"10/10/2024 10 p.m. PDT",985,1011,931,-54
SCL,"10/10/2024 11 p.m. PDT",920,946,968,48
SCL,"10/11/2024 12 a.m. PDT",856,878,902,46
SCL,"10/11/2024 1 a.m. PDT",806,811,801,-5
SCL,"10/11/2024 2 a.m. PDT",769,778,700,-69
SCL,"10/11/2024 3 a.m. PDT",756,762,645,-111
SCL,"10/11/2024 4 a.m. PDT",745,763,633,-112
SCL,"10/11/2024 5 a.m. PDT",769,793,663,-106
SCL,"10/11/2024 6 a.m. PDT",837,871,601,-236
SCL,"10/11/2024 7 a.m. PDT",944,1003,135,-809
SCL,"10/11/2024 8 a.m. PDT",1037,1106,171,-866
SCL,"10/11/2024 9 a.m. PDT",1075,1126,214,-861
SCL,"10/11/2024 10 a.m. PDT",1088,1113,131,-957
SCL,"10/11/2024 11 a.m. PDT",1104,1088,124,-980
SCL,"10/11/2024 12 p.m. PDT",1090,1053,121,-969
SCL,"10/11/2024 1 p.m. PDT",1073,1028,111,-962
SCL,"10/11/2024 2 p.m. PDT",1079,1016,104,-975
SCL,"10/11/2024 3 p.m. PDT",1077,998,106,-971
SCL,"10/11/2024 4 p.m. PDT",1065,993,151,-914
SCL,"10/11/2024 5 p.m. PDT",1088,1009,223,-865
SCL,"10/11/2024 6 p.m. PDT",1096,1020,272,-824
SCL,"10/11/2024 7 p.m. PDT",1098,1026,292,-806
SCL,"10/11/2024 8 p.m. PDT",1095,1019,954,-141
SCL,"10/11/2024 9 p.m. PDT",1061,989,982,-79
SCL,"10/11/2024 10 p.m. PDT",996,951,780,-216
SCL,"10/11/2024 11 p.m. PDT",967,904,869,-98
SCL,"10/12/2024 12 a.m. PDT",909,859,804,-105
SCL,"10/12/2024 1 a.m. PDT",868,823,648,-220
SCL,"10/12/2024 2 a.m. PDT",834,790,653,-181
SCL,"10/12/2024 3 a.m. PDT",814,769,549,-265
SCL,"10/12/2024 4 a.m. PDT",802,761,650,-152
SCL,"10/12/2024 5 a.m. PDT",808,770,753,-55
SCL,"10/12/2024 6 a.m. PDT",833,802,734,-99
SCL,"10/12/2024 7 a.m. PDT",892,855,205,-687
SCL,"10/12/2024 8 a.m. PDT",954,915,241,-713
SCL,"10/12/2024 9 a.m. PDT",1009,961,207,-802
SCL,"10/12/2024 10 a.m. PDT",1030,981,137,-893
SCL,"10/12/2024 11 a.m. PDT",1028,986,132,-896
SCL,"10/12/2024 12 p.m. PDT",1014,976,122,-892
SCL,"10/12/2024 1 p.m. PDT",999,964,117,-882
SCL,"10/12/2024 2 p.m. PDT",972,954,107,-865
SCL,"10/12/2024 3 p.m. PDT",959,951,108,-851
SCL,"10/12/2024 4 p.m. PDT",976,952,152,-824
SCL,"10/12/2024 5 p.m. PDT",976,966,356,-620
SCL,"10/12/2024 6 p.m. PDT",1006,984,481,-525
SCL,"10/12/2024 7 p.m. PDT",1018,1004,978,-40
SCL,"10/12/2024 8 p.m. PDT",1030,1003,979,-51
SCL,"10/12/2024 9 p.m. PDT",1010,979,933,-77
SCL,"10/12/2024 10 p.m. PDT",981,946,836,-145
SCL,"10/12/2024 11 p.m. PDT",935,902,815,-120
SCL,"10/13/2024 12 a.m. PDT",884,850,804,-80
SCL,"10/13/2024 1 a.m. PDT",824,799,554,-270
SCL,"10/13/2024 2 a.m. PDT",811,763,526,-285
SCL,"10/13/2024 3 a.m. PDT",784,741,505,-279
SCL,"10/13/2024 4 a.m. PDT",772,732,495,-277
SCL,"10/13/2024 5 a.m. PDT",777,739,466,-311
SCL,"10/13/2024 6 a.m. PDT",796,763,477,-319
SCL,"10/13/2024 7 a.m. PDT",836,811,572,-264
SCL,"10/13/2024 8 a.m. PDT",836,866,675,-161
SCL,"10/13/2024 9 a.m. PDT",919,910,751,-168
SCL,"10/13/2024 10 a.m. PDT",950,946,772,-178
SCL,"10/13/2024 11 a.m. PDT",975,966,568,-407
SCL,"10/13/2024 12 p.m. PDT",949,976,562,-387
SCL,"10/13/2024 1 p.m. PDT",980,980,568,-412
SCL,"10/13/2024 2 p.m. PDT",985,983,568,-417
SCL,"10/13/2024 3 p.m. PDT",972,985,567,-405
SCL,"10/13/2024 4 p.m. PDT",982,990,800,-182
SCL,"10/13/2024 5 p.m. PDT",1007,1007,910,-97
SCL,"10/13/2024 6 p.m. PDT",1048,1040,987,-61
SCL,"10/13/2024 7 p.m. PDT",1067,1066,971,-96
SCL,"10/13/2024 8 p.m. PDT",1083,1066,944,-139
SCL,"10/13/2024 9 p.m. PDT",1040,1033,957,-83
SCL,"10/13/2024 10 p.m. PDT",989,981,867,-122
SCL,"10/13/2024 11 p.m. PDT",930,917,731,-199
SCL,"10/14/2024 12 a.m. PDT",864,849,678,-186
SCL,"10/14/2024 1 a.m. PDT",818,775,527,-291
SCL,"10/14/2024 2 a.m. PDT",772,738,470,-302
SCL,"10/14/2024 3 a.m. PDT",713,719,471,-242
SCL,"10/14/2024 4 a.m. PDT",715,719,471,-244
SCL,"10/14/2024 5 a.m. PDT",732,741,473,-259
SCL,"10/14/2024 6 a.m. PDT",790,807,534,-256
SCL,"10/14/2024 7 a.m. PDT",895,916,268,-627
SCL,"10/14/2024 8 a.m. PDT",980,1006,242,-738
SCL,"10/14/2024 9 a.m. PDT",1011,1038,171,-840
SCL,"10/14/2024 10 a.m. PDT",1036,1054,114,-922
SCL,"10/14/2024 11 a.m. PDT",1061,1067,101,-960
SCL,"10/14/2024 12 p.m. PDT",1091,1070,96,-995
SCL,"10/14/2024 1 p.m. PDT",1093,1074,91,-1002
SCL,"10/14/2024 2 p.m. PDT",1087,1073,92,-995
SCL,"10/14/2024 3 p.m. PDT",1083,1055,88,-995
SCL,"10/14/2024 4 p.m. PDT",1077,1052,121,-956
SCL,"10/14/2024 5 p.m. PDT",1093,1062,245,-848
SCL,"10/14/2024 6 p.m. PDT",1118,1089,277,-841
SCL,"10/14/2024 7 p.m. PDT",1126,1102,383,-743
SCL,"10/14/2024 8 p.m. PDT",1113,1098,1023,-90
SCL,"10/14/2024 9 p.m. PDT",1072,1060,977,-95
SCL,"10/14/2024 10 p.m. PDT",1020,1004,912,-108
SCL,"10/14/2024 11 p.m. PDT",938,931,987,49
SCL,"10/15/2024 12 a.m. PDT",877,850,941,64
SCL,"10/15/2024 1 a.m. PDT",824,780,796,-28
SCL,"10/15/2024 2 a.m. PDT",787,742,774,-13
SCL,"10/15/2024 3 a.m. PDT",772,724,770,-2
SCL,"10/15/2024 4 a.m. PDT",764,721,761,-3
SCL,"10/15/2024 5 a.m. PDT",783,743,762,-21
SCL,"10/15/2024 6 a.m. PDT",845,811,796,-49
SCL,"10/15/2024 7 a.m. PDT",961,934,270,-691
SCL,"10/15/2024 8 a.m. PDT",1064,1043,246,-818
SCL,"10/15/2024 9 a.m. PDT",1084,1068,240,-844
SCL,"10/15/2024 10 a.m. PDT",1082,1068,109,-973
SCL,"10/15/2024 11 a.m. PDT",1073,1063,105,-968
SCL,"10/15/2024 12 p.m. PDT",1089,1058,101,-988
SCL,"10/15/2024 1 p.m. PDT",1053,1057,89,-964
SCL,"10/15/2024 2 p.m. PDT",1077,1047,90,-987
SCL,"10/15/2024 3 p.m. PDT",1069,1036,87,-982
SCL,"10/15/2024 4 p.m. PDT",1065,1035,86,-979
SCL,"10/15/2024 5 p.m. PDT",1082,1047,88,-994
SCL,"10/15/2024 6 p.m. PDT",1104,1070,267,-837
SCL,"10/15/2024 7 p.m. PDT",1080,1086,301,-779
SCL,"10/15/2024 8 p.m. PDT",1067,1081,884,-183
SCL,"10/15/2024 9 p.m. PDT",1035,1044,933,-102
SCL,"10/15/2024 10 p.m. PDT",981,992,799,-182
SCL,"10/15/2024 11 p.m. PDT",910,918,785,-125
SCL,"10/16/2024 12 a.m. PDT",843,849,784,-59
SCL,"10/16/2024 1 a.m. PDT",788,795,787,-1
SCL,"10/16/2024 2 a.m. PDT",755,763,780,25
SCL,"10/16/2024 3 a.m. PDT",732,745,775,43
SCL,"10/16/2024 4 a.m. PDT",728,743,769,41
SCL,"10/16/2024 5 a.m. PDT",757,764,770,13
SCL,"10/16/2024 6 a.m. PDT",820,835,732,-88
SCL,"10/16/2024 7 a.m. PDT",944,958,256,-688
SCL,"10/16/2024 8 a.m. PDT",1042,1061,256,-786
SCL,"10/16/2024 9 a.m. PDT",1068,1084,250,-818
SCL,"10/16/2024 10 a.m. PDT",1060,1085,108,-952
SCL,"10/16/2024 11 a.m. PDT",1050,1082,101,-949
SCL,"10/16/2024 12 p.m. PDT",1033,1073,93,-940
SCL,"10/16/2024 1 p.m. PDT",1034,1066,85,-949
SCL,"10/16/2024 2 p.m. PDT",1016,1060,89,-927
SCL,"10/16/2024 3 p.m. PDT",1019,1050,84,-935
SCL,"10/16/2024 4 p.m. PDT",1002,1052,91,-911
SCL,"10/16/2024 5 p.m. PDT",1013,1063,120,-893
SCL,"10/16/2024 6 p.m. PDT",1045,1086,194,-851
SCL,"10/16/2024 7 p.m. PDT",1075,1108,305,-770
SCL,"10/16/2024 8 p.m. PDT",1075,1112,887,-188
SCL,"10/16/2024 9 p.m. PDT",1042,1082,831,-211
SCL,"10/16/2024 10 p.m. PDT",996,1029,823,-173
SCL,"10/16/2024 11 p.m. PDT",924,959,879,-45
SCL,"10/17/2024 12 a.m. PDT",851,882,838,-13
SCL,"10/17/2024 1 a.m. PDT",807,811,801,-6
SCL,"10/17/2024 2 a.m. PDT",769,779,763,-6
SCL,"10/17/2024 3 a.m. PDT",753,763,710,-43
SCL,"10/17/2024 4 a.m. PDT",757,763,688,-69
SCL,"10/17/2024 5 a.m. PDT",785,790,661,-124
SCL,"10/17/2024 6 a.m. PDT",856,868,699,-157
SCL,"10/17/2024 7 a.m. PDT",996,1005,266,-730
SCL,"10/17/2024 8 a.m. PDT",1102,1116,269,-833
SCL,"10/17/2024 9 a.m. PDT",1124,1133,254,-870
SCL,"10/17/2024 10 a.m. PDT",1097,1128,106,-991
SCL,"10/17/2024 11 a.m. PDT",1087,1116,98,-989
SCL,"10/17/2024 12 p.m. PDT",1099,1103,93,-1006
SCL,"10/17/2024 1 p.m. PDT",1103,1085,85,-1018
SCL,"10/17/2024 2 p.m. PDT",1059,1068,84,-975
SCL,"10/17/2024 3 p.m. PDT",1041,1048,86,-955
SCL,"10/17/2024 4 p.m. PDT",1025,1046,83,-942
SCL,"10/17/2024 5 p.m. PDT",1046,1045,238,-808
SCL,"10/17/2024 6 p.m. PDT",1081,1077,376,-705
SCL,"10/17/2024 7 p.m. PDT",1104,1110,621,-483
SCL,"10/17/2024 8 p.m. PDT",1102,1107,898,-204
SCL,"10/17/2024 9 p.m. PDT",1073,1079,922,-151
SCL,"10/17/2024 10 p.m. PDT",1028,1029,888,-140
SCL,"10/17/2024 11 p.m. PDT",951,964,891,-60
SCL,"10/18/2024 12 a.m. PDT",878,894,847,-31
SCL,"10/18/2024 1 a.m. PDT",831,837,761,-70
SCL,"10/18/2024 2 a.m. PDT",790,804,681,-109
SCL,"10/18/2024 3 a.m. PDT",776,788,633,-143
SCL,"10/18/2024 4 a.m. PDT",780,792,674,-106
SCL,"10/18/2024 5 a.m. PDT",802,827,728,-74
SCL,"10/18/2024 6 a.m. PDT",883,912,729,-154
SCL,"10/18/2024 7 a.m. PDT",1004,1043,218,-786
SCL,"10/18/2024 8 a.m. PDT",1105,1150,232,-873
SCL,"10/18/2024 9 a.m. PDT",1138,1183,157,-981
SCL,"10/18/2024 10 a.m. PDT",1150,1178,119,-1031
SCL,"10/18/2024 11 a.m. PDT",1180,1160,117,-1063
SCL,"10/18/2024 12 p.m. PDT",1207,1137,125,-1082
SCL,"10/18/2024 1 p.m. PDT",1228,1129,223,-1005
SCL,"10/18/2024 2 p.m. PDT",1224,1122,100,-1124
SCL,"10/18/2024 3 p.m. PDT",1195,1108,100,-1095
SCL,"10/18/2024 4 p.m. PDT",1187,1090,96,-1091
SCL,"10/18/2024 5 p.m. PDT",1197,1101,123,-1074
SCL,"10/18/2024 6 p.m. PDT",1208,1116,368,-840
SCL,"10/18/2024 7 p.m. PDT",1203,1120,555,-648
SCL,"10/18/2024 8 p.m. PDT",1168,1099,876,-292
SCL,"10/18/2024 9 p.m. PDT",1128,1056,806,-322
SCL,"10/18/2024 10 p.m. PDT",1079,1015,795,-284
SCL,"10/18/2024 11 p.m. PDT",1020,958,894,-126
SCL,"10/19/2024 12 a.m. PDT",952,903,828,-124
SCL,"10/19/2024 1 a.m. PDT",901,866,795,-106
SCL,"10/19/2024 2 a.m. PDT",865,823,703,-162
SCL,"10/19/2024 3 a.m. PDT",826,798,747,-79
SCL,"10/19/2024 4 a.m. PDT",814,786,764,-50
SCL,"10/19/2024 5 a.m. PDT",819,795,790,-29
SCL,"10/19/2024 6 a.m. PDT",847,826,757,-90
SCL,"10/19/2024 7 a.m. PDT",890,877,156,-734
SCL,"10/19/2024 8 a.m. PDT",933,939,155,-778
SCL,"10/19/2024 9 a.m. PDT",996,998,131,-865
SCL,"10/19/2024 10 a.m. PDT",1048,1043,126,-922
SCL,"10/19/2024 11 a.m. PDT",1058,1057,128,-930
SCL,"10/19/2024 12 p.m. PDT",1079,1062,135,-944
SCL,"10/19/2024 1 p.m. PDT",1073,1063,131,-942
SCL,"10/19/2024 2 p.m. PDT",1072,1055,134,-938
SCL,"10/19/2024 3 p.m. PDT",1059,1048,133,-926
SCL,"10/19/2024 4 p.m. PDT",1058,1046,135,-923
SCL,"10/19/2024 5 p.m. PDT",1050,1050,544,-506
SCL,"10/19/2024 6 p.m. PDT",1057,1068,669,-388
SCL,"10/19/2024 7 p.m. PDT",1077,1091,673,-404
SCL,"10/19/2024 8 p.m. PDT",1058,1078,786,-272
SCL,"10/19/2024 9 p.m. PDT",1031,1051,779,-252
SCL,"10/19/2024 10 p.m. PDT",997,1008,770,-227
SCL,"10/19/2024 11 p.m. PDT",928,965,829,-99
SCL,"10/20/2024 12 a.m. PDT",892,911,819,-73
SCL,"10/20/2024 1 a.m. PDT",848,810,774,-74
SCL,"10/20/2024 2 a.m. PDT",812,775,639,-173
SCL,"10/20/2024 3 a.m. PDT",784,752,610,-174
SCL,"10/20/2024 4 a.m. PDT",776,740,612,-164
SCL,"10/20/2024 5 a.m. PDT",769,742,588,-181
SCL,"10/20/2024 6 a.m. PDT",783,764,649,-134
SCL,"10/20/2024 7 a.m. PDT",821,809,696,-125
SCL,"10/20/2024 8 a.m. PDT",861,862,705,-156
SCL,"10/20/2024 9 a.m. PDT",901,914,786,-115
SCL,"10/20/2024 10 a.m. PDT",939,963,730,-209
SCL,"10/20/2024 11 a.m. PDT",970,989,781,-189
SCL,"10/20/2024 12 p.m. PDT",947,1001,725,-222
SCL,"10/20/2024 1 p.m. PDT",984,1009,718,-266
SCL,"10/20/2024 2 p.m. PDT",997,1013,646,-351
SCL,"10/20/2024 3 p.m. PDT",1011,1015,611,-400
SCL,"10/20/2024 4 p.m. PDT",1006,1014,678,-328
SCL,"10/20/2024 5 p.m. PDT",1041,1024,733,-308
SCL,"10/20/2024 6 p.m. PDT",1058,1059,819,-239
SCL,"10/20/2024 7 p.m. PDT",1086,1092,816,-270
SCL,"10/20/2024 8 p.m. PDT",1092,1084,828,-264
SCL,"10/20/2024 9 p.m. PDT",1061,1056,831,-230
SCL,"10/20/2024 10 p.m. PDT",1020,1010,825,-195
SCL,"10/20/2024 11 p.m. PDT",955,951,737,-218
SCL,"10/21/2024 12 a.m. PDT",882,884,696,-186
SCL,"10/21/2024 1 a.m. PDT",828,797,570,-258
SCL,"10/21/2024 2 a.m. PDT",801,766,567,-234
SCL,"10/21/2024 3 a.m. PDT",784,753,559,-225
SCL,"10/21/2024 4 a.m. PDT",792,755,544,-248
SCL,"10/21/2024 5 a.m. PDT",817,783,553,-264
SCL,"10/21/2024 6 a.m. PDT",887,859,550,-337
SCL,"10/21/2024 7 a.m. PDT",1023,988,397,-626
SCL,"10/21/2024 8 a.m. PDT",1122,1100,376,-746
SCL,"10/21/2024 9 a.m. PDT",1143,1125,375,-768
SCL,"10/21/2024 10 a.m. PDT",1148,1123,375,-773
SCL,"10/21/2024 11 a.m. PDT",1105,1113,237,-868
SCL,"10/21/2024 12 p.m. PDT",1095,1103,230,-865
SCL,"10/21/2024 1 p.m. PDT",1118,1092,229,-889
SCL,"10/21/2024 2 p.m. PDT",1122,1077,270,-852
SCL,"10/21/2024 3 p.m. PDT",1121,1059,274,-847
SCL,"10/21/2024 4 p.m. PDT",1120,1054,259,-861
SCL,"10/21/2024 5 p.m. PDT",1132,1074,257,-875
SCL,"10/21/2024 6 p.m. PDT",1160,1108,453,-707
SCL,"10/21/2024 7 p.m. PDT",1179,1130,442,-737
SCL,"10/21/2024 8 p.m. PDT",1177,1109,816,-361
SCL,"10/21/2024 9 p.m. PDT",1147,1075,729,-418
SCL,"10/21/2024 10 p.m. PDT",1099,1020,717,-382
SCL,"10/21/2024 11 p.m. PDT",1019,947,753,-266
SCL,"10/22/2024 12 a.m. PDT",943,879,726,-217
SCL,"10/22/2024 1 a.m. PDT",889,850,627,-262
SCL,"10/22/2024 2 a.m. PDT",857,817,634,-223
SCL,"10/22/2024 3 a.m. PDT",830,800,596,-234
SCL,"10/22/2024 4 a.m. PDT",833,800,609,-224
SCL,"10/22/2024 5 a.m. PDT",880,827,622,-258
SCL,"10/22/2024 6 a.m. PDT",948,905,675,-273
SCL,"10/22/2024 7 a.m. PDT",1094,1040,789,-305
SCL,"10/22/2024 8 a.m. PDT",1191,1150,812,-379
SCL,"10/22/2024 9 a.m. PDT",1213,1171,583,-630
SCL,"10/22/2024 10 a.m. PDT",1193,1153,393,-800
SCL,"10/22/2024 11 a.m. PDT",1173,1130,380,-793
SCL,"10/22/2024 12 p.m. PDT",1125,1106,374,-751
SCL,"10/22/2024 1 p.m. PDT",1128,1087,391,-737
SCL,"10/22/2024 2 p.m. PDT",1111,1068,384,-727
SCL,"10/22/2024 3 p.m. PDT",1093,1046,366,-727
SCL,"10/22/2024 4 p.m. PDT",1083,1043,388,-695
SCL,"10/22/2024 5 p.m. PDT",1106,1057,597,-509
SCL,"10/22/2024 6 p.m. PDT",1139,1098,872,-267
SCL,"10/22/2024 7 p.m. PDT",1137,1136,920,-217
SCL,"10/22/2024 8 p.m. PDT",1135,1133,908,-227
SCL,"10/22/2024 9 p.m. PDT",1114,1104,880,-234
SCL,"10/22/2024 10 p.m. PDT",1058,1057,805,-253
SCL,"10/22/2024 11 p.m. PDT",989,986,781,-208
SCL,"10/23/2024 12 a.m. PDT",911,916,755,-156
SCL,"10/23/2024 1 a.m. PDT",863,873,637,-226
SCL,"10/23/2024 2 a.m. PDT",828,839,565,-263
SCL,"10/23/2024 3 a.m. PDT",815,824,541,-274
SCL,"10/23/2024 4 a.m. PDT",812,827,265,-547
SCL,"10/23/2024 5 a.m. PDT",835,859,259,-576
SCL,"10/23/2024 6 a.m. PDT",918,945,650,-268
SCL,"10/23/2024 7 a.m. PDT",1051,1081,279,-772
SCL,"10/23/2024 8 a.m. PDT",1167,1189,220,-947
SCL,"10/23/2024 9 a.m. PDT",1196,1204,198,-998
SCL,"10/23/2024 10 a.m. PDT",1188,1195,144,-1044
SCL,"10/23/2024 11 a.m. PDT",1183,1183,108,-1075
SCL,"10/23/2024 12 p.m. PDT",1166,1170,100,-1066
SCL,"10/23/2024 1 p.m. PDT",1143,1159,101,-1042
SCL,"10/23/2024 2 p.m. PDT",1124,1140,95,-1029
SCL,"10/23/2024 3 p.m. PDT",1095,1121,87,-1008
SCL,"10/23/2024 4 p.m. PDT",1075,1115,94,-981
SCL,"10/23/2024 5 p.m. PDT",1089,1119,494,-595
SCL,"10/23/2024 6 p.m. PDT",1128,1157,859,-269
SCL,"10/23/2024 7 p.m. PDT",1160,1184,903,-257
SCL,"10/23/2024 8 p.m. PDT",1158,1171,936,-222
SCL,"10/23/2024 9 p.m. PDT",1125,1140,959,-166
SCL,"10/23/2024 10 p.m. PDT",1077,1086,915,-162
SCL,"10/23/2024 11 p.m. PDT",997,1015,785,-212
SCL,"10/24/2024 12 a.m. PDT",921,947,644,-277
SCL,"10/24/2024 1 a.m. PDT",865,878,535,-330
SCL,"10/24/2024 2 a.m. PDT",828,840,536,-292
SCL,"10/24/2024 3 a.m. PDT",810,824,539,-271
SCL,"10/24/2024 4 a.m. PDT",817,827,548,-269
SCL,"10/24/2024 5 a.m. PDT",850,864,650,-200
SCL,"10/24/2024 6 a.m. PDT",938,957,724,-214
SCL,"10/24/2024 7 a.m. PDT",1077,1099,175,-902
SCL,"10/24/2024 8 a.m. PDT",1178,1211,195,-983
SCL,"10/24/2024 9 a.m. PDT",1209,1233,192,-1017
SCL,"10/24/2024 10 a.m. PDT",1198,1222,135,-1063
SCL,"10/24/2024 11 a.m. PDT",1180,1204,113,-1067
SCL,"10/24/2024 12 p.m. PDT",1145,1183,113,-1032
SCL,"10/24/2024 1 p.m. PDT",1117,1163,97,-1020
SCL,"10/24/2024 2 p.m. PDT",1086,1142,88,-998
SCL,"10/24/2024 3 p.m. PDT",1064,1114,83,-981
SCL,"10/24/2024 4 p.m. PDT",1066,1105,128,-938
SCL,"10/24/2024 5 p.m. PDT",1093,1129,329,-764
SCL,"10/24/2024 6 p.m. PDT",1124,1168,639,-485
SCL,"10/24/2024 7 p.m. PDT",1157,1203,869,-288
SCL,"10/24/2024 8 p.m. PDT",1156,1189,914,-242
SCL,"10/24/2024 9 p.m. PDT",1125,1164,837,-288
SCL,"10/24/2024 10 p.m. PDT",1079,1111,833,-246
SCL,"10/24/2024 11 p.m. PDT",1007,1040,890,-117
SCL,"10/25/2024 12 a.m. PDT",940,969,763,-177
SCL,"10/25/2024 1 a.m. PDT",887,896,597,-290
SCL,"10/25/2024 2 a.m. PDT",848,860,575,-273
SCL,"10/25/2024 3 a.m. PDT",836,843,577,-259
SCL,"10/25/2024 4 a.m. PDT",833,845,522,-311
SCL,"10/25/2024 5 a.m. PDT",867,877,532,-335
SCL,"10/25/2024 6 a.m. PDT",948,963,806,-142
SCL,"10/25/2024 7 a.m. PDT",1072,1090,815,-257
SCL,"10/25/2024 8 a.m. PDT",1187,1193,845,-342
SCL,"10/25/2024 9 a.m. PDT",1217,1221,838,-379
SCL,"10/25/2024 10 a.m. PDT",1198,1213,813,-385
SCL,"10/25/2024 11 a.m. PDT",1192,1193,787,-405
SCL,"10/25/2024 12 p.m. PDT",1178,1156,513,-665
SCL,"10/25/2024 1 p.m. PDT",1153,1130,396,-757
SCL,"10/25/2024 2 p.m. PDT",1113,1112,394,-719
SCL,"10/25/2024 3 p.m. PDT",1111,1094,395,-716
SCL,"10/25/2024 4 p.m. PDT",1114,1087,580,-534
SCL,"10/25/2024 5 p.m. PDT",1125,1097,652,-473
SCL,"10/25/2024 6 p.m. PDT",1139,1120,817,-322
SCL,"10/25/2024 7 p.m. PDT",1149,1129,806,-343
SCL,"10/25/2024 8 p.m. PDT",1120,1099,733,-387
SCL,"10/25/2024 9 p.m. PDT",1105,1068,729,-376
SCL,"10/25/2024 10 p.m. PDT",1059,1027,702,-357
SCL,"10/25/2024 11 p.m. PDT",1005,969,734,-271
SCL,"10/26/2024 12 a.m. PDT",939,913,704,-235
SCL,"10/26/2024 1 a.m. PDT",902,852,562,-340
SCL,"10/26/2024 2 a.m. PDT",870,821,561,-309
SCL,"10/26/2024 3 a.m. PDT",843,796,562,-281
SCL,"10/26/2024 4 a.m. PDT",829,784,562,-267
SCL,"10/26/2024 5 a.m. PDT",835,791,562,-273
SCL,"10/26/2024 6 a.m. PDT",852,821,557,-295
SCL,"10/26/2024 7 a.m. PDT",896,871,461,-435
SCL,"10/26/2024 8 a.m. PDT",953,933,470,-483
SCL,"10/26/2024 9 a.m. PDT",1012,997,489,-523
SCL,"10/26/2024 10 a.m. PDT",1049,1040,408,-641
SCL,"10/26/2024 11 a.m. PDT",1069,1060,387,-682
SCL,"10/26/2024 12 p.m. PDT",1093,1077,389,-704
SCL,"10/26/2024 1 p.m. PDT",1086,1084,376,-710
SCL,"10/26/2024 2 p.m. PDT",1078,1077,379,-699
SCL,"10/26/2024 3 p.m. PDT",1069,1063,376,-693
SCL,"10/26/2024 4 p.m. PDT",1065,1056,384,-681
SCL,"10/26/2024 5 p.m. PDT",1078,1058,640,-438
SCL,"10/26/2024 6 p.m. PDT",1096,1078,755,-341
SCL,"10/26/2024 7 p.m. PDT",1115,1103,783,-332
SCL,"10/26/2024 8 p.m. PDT",1098,1079,795,-303
SCL,"10/26/2024 9 p.m. PDT",1043,1050,670,-373
SCL,"10/26/2024 10 p.m. PDT",1027,1009,634,-393
SCL,"10/26/2024 11 p.m. PDT",987,966,632,-355
SCL,"10/27/2024 12 a.m. PDT",920,910,526,-394
SCL,"10/27/2024 1 a.m. PDT",884,846,539,-345
SCL,"10/27/2024 2 a.m. PDT",848,805,545,-303
SCL,"10/27/2024 3 a.m. PDT",829,781,559,-270
SCL,"10/27/2024 4 a.m. PDT",816,767,578,-238
SCL,"10/27/2024 5 a.m. PDT",824,766,573,-251
SCL,"10/27/2024 6 a.m. PDT",823,788,573,-250
SCL,"10/27/2024 7 a.m. PDT",890,836,454,-436
SCL,"10/27/2024 8 a.m. PDT",936,891,437,-499
SCL,"10/27/2024 9 a.m. PDT",969,939,445,-524
SCL,"10/27/2024 10 a.m. PDT",1024,983,443,-581
SCL,"10/27/2024 11 a.m. PDT",1042,1004,442,-600
SCL,"10/27/2024 12 p.m. PDT",1043,1011,442,-601
SCL,"10/27/2024 1 p.m. PDT",1072,1019,447,-625
SCL,"10/27/2024 2 p.m. PDT",1062,1021,443,-619
SCL,"10/27/2024 3 p.m. PDT",1096,1021,450,-646
SCL,"10/27/2024 4 p.m. PDT",1108,1027,445,-663
SCL,"10/27/2024 5 p.m. PDT",1143,1042,624,-519
SCL,"10/27/2024 6 p.m. PDT",1162,1091,707,-455
SCL,"10/27/2024 7 p.m. PDT",1209,1127,689,-520
SCL,"10/27/2024 8 p.m. PDT",1193,1116,686,-507
SCL,"10/27/2024 9 p.m. PDT",1154,1085,688,-466
SCL,"10/27/2024 10 p.m. PDT",1108,1032,653,-455
SCL,"10/27/2024 11 p.m. PDT",1041,963,550,-491
SCL,"10/28/2024 12 a.m. PDT",948,896,548,-400
SCL,"10/28/2024 1 a.m. PDT",905,872,413,-492
SCL,"10/28/2024 2 a.m. PDT",882,840,410,-472
SCL,"10/28/2024 3 a.m. PDT",864,826,408,-456
SCL,"10/28/2024 4 a.m. PDT",868,827,409,-459
SCL,"10/28/2024 5 a.m. PDT",904,851,415,-489
SCL,"10/28/2024 6 a.m. PDT",985,928,550,-435
SCL,"10/28/2024 7 a.m. PDT",1113,1053,592,-521
SCL,"10/28/2024 8 a.m. PDT",1227,1153,667,-560
SCL,"10/28/2024 9 a.m. PDT",1254,1170,527,-727
SCL,"10/28/2024 10 a.m. PDT",1256,1167,526,-730
SCL,"10/28/2024 11 a.m. PDT",1255,1152,380,-875
SCL,"10/28/2024 12 p.m. PDT",1207,1135,374,-833
SCL,"10/28/2024 1 p.m. PDT",1221,1116,380,-841
SCL,"10/28/2024 2 p.m. PDT",1206,1103,379,-827
SCL,"10/28/2024 3 p.m. PDT",1185,1086,378,-807
SCL,"10/28/2024 4 p.m. PDT",1166,1073,394,-772
SCL,"10/28/2024 5 p.m. PDT",1167,1094,436,-731
SCL,"10/28/2024 6 p.m. PDT",1208,1136,625,-583
SCL,"10/28/2024 7 p.m. PDT",1244,1169,629,-615
SCL,"10/28/2024 8 p.m. PDT",1214,1139,625,-589
SCL,"10/28/2024 9 p.m. PDT",1186,1107,580,-606
SCL,"10/28/2024 10 p.m. PDT",1133,1052,541,-592
SCL,"10/28/2024 11 p.m. PDT",1053,977,572,-481
SCL,"10/29/2024 12 a.m. PDT",973,911,527,-446
SCL,"10/29/2024 1 a.m. PDT",924,877,533,-391
SCL,"10/29/2024 2 a.m. PDT",878,845,534,-344
SCL,"10/29/2024 3 a.m. PDT",865,829,477,-388
SCL,"10/29/2024 4 a.m. PDT",865,831,483,-382
SCL,"10/29/2024 5 a.m. PDT",898,864,529,-369
SCL,"10/29/2024 6 a.m. PDT",982,950,481,-501
SCL,"10/29/2024 7 a.m. PDT",1052,1092,396,-656
SCL,"10/29/2024 8 a.m. PDT",1168,1206,514,-654
SCL,"10/29/2024 9 a.m. PDT",1187,1223,481,-706
SCL,"10/29/2024 10 a.m. PDT",1174,1215,580,-594
SCL,"10/29/2024 11 a.m. PDT",1166,1202,498,-668
SCL,"10/29/2024 12 p.m. PDT",1160,1190,478,-682
SCL,"10/29/2024 1 p.m. PDT",1151,1183,474,-677
SCL,"10/29/2024 2 p.m. PDT",1123,1165,471,-652
SCL,"10/29/2024 3 p.m. PDT",1077,1144,475,-602
SCL,"10/29/2024 4 p.m. PDT",1072,1134,504,-568
SCL,"10/29/2024 5 p.m. PDT",1096,1140,609,-487
SCL,"10/29/2024 6 p.m. PDT",1138,1183,616,-522
SCL,"10/29/2024 7 p.m. PDT",1186,1218,675,-511
SCL,"10/29/2024 8 p.m. PDT",1182,1197,733,-449
SCL,"10/29/2024 9 p.m. PDT",1149,1163,712,-437
SCL,"10/29/2024 10 p.m. PDT",1096,1108,696,-400
SCL,"10/29/2024 11 p.m. PDT",1027,1033,689,-338
SCL,"10/30/2024 12 a.m. PDT",950,961,634,-316
SCL,"10/30/2024 1 a.m. PDT",902,907,573,-329
SCL,"10/30/2024 2 a.m. PDT",864,,565,-299
SCL,"10/30/2024 3 a.m. PDT",841,,568,-273
SCL,"10/30/2024 4 a.m. PDT",848,,574,-274
SCL,"10/30/2024 5 a.m. PDT",879,,574,-305
SCL,"10/30/2024 6 a.m. PDT",968,,697,-271
SCL,"10/30/2024 7 a.m. PDT",1101,,602,-499
SCL,"10/30/2024 8 a.m. PDT",1216,,650,-566
SCL,"10/30/2024 9 a.m. PDT",1233,,533,-700
SCL,"10/30/2024 10 a.m. PDT",1224,,387,-837
SCL,"10/30/2024 11 a.m. PDT",1225,,388,-837
SCL,"10/30/2024 12 p.m. PDT",1221,,390,-831
SCL,"10/30/2024 1 p.m. PDT",1220,,391,-829
SCL,"10/30/2024 2 p.m. PDT",1234,,389,-845
SCL,"10/30/2024 3 p.m. PDT",1233,,386,-847
SCL,"10/30/2024 4 p.m. PDT",1226,,507,-719
SCL,"10/30/2024 5 p.m. PDT",1225,,657,-568
SCL,"10/30/2024 6 p.m. PDT",1253,,723,-530
SCL,"10/30/2024 7 p.m. PDT",1260,,796,-464
SCL,"10/30/2024 8 p.m. PDT",1239,,788,-451
SCL,"10/30/2024 9 p.m. PDT",1195,,738,-457
SCL,"10/30/2024 10 p.m. PDT",1149,,608,-541
SCL,"10/30/2024 11 p.m. PDT",1057,,721,-336
SCL,"10/31/2024 12 a.m. PDT",980,,636,-344
SCL,"10/31/2024 1 a.m. PDT",916,931,565,-351
SCL,"10/31/2024 2 a.m. PDT",885,890,565,-320
SCL,"10/31/2024 3 a.m. PDT",870,874,562,-308
SCL,"10/31/2024 4 a.m. PDT",869,877,481,-388
SCL,"10/31/2024 5 a.m. PDT",903,911,487,-416
SCL,"10/31/2024 6 a.m. PDT",987,999,602,-385
SCL,"10/31/2024 7 a.m. PDT",1129,1143,687,-442
SCL,"10/31/2024 8 a.m. PDT",1241,1260,763,-478
SCL,"10/31/2024 9 a.m. PDT",1259,1278,798,-461
SCL,"10/31/2024 10 a.m. PDT",1245,1269,701,-544
SCL,"10/31/2024 11 a.m. PDT",1204,1250,470,-734
SCL,"10/31/2024 12 p.m. PDT",1198,1227,436,-762
SCL,"10/31/2024 1 p.m. PDT",1181,1212,443,-738
SCL,"10/31/2024 2 p.m. PDT",1181,1191,472,-709
SCL,"10/31/2024 3 p.m. PDT",1167,1178,407,-760
SCL,"10/31/2024 4 p.m. PDT",1174,1166,424,-750
SCL,"10/31/2024 5 p.m. PDT",1202,1193,584,-618
SCL,"10/31/2024 6 p.m. PDT",1227,1240,799,-428
SCL,"10/31/2024 7 p.m. PDT",1206,1256,792,-414
SCL,"10/31/2024 8 p.m. PDT",1185,1235,774,-411
SCL,"10/31/2024 9 p.m. PDT",1158,1195,711,-447
SCL,"10/31/2024 10 p.m. PDT",1108,1141,738,-370
SCL,"10/31/2024 11 p.m. PDT",1037,1062,777,-260