"BA Code","Timestamp (Hour Ending)","Demand (MWh)","Demand Forecast (MWh)","Net Generation (MWh)","Total Interchange (MWh)"
SCL,"11/1/2024 12 a.m. PDT",966,993,709,-257
SCL,"11/1/2024 1 a.m. PDT",911,917,468,-443
SCL,"11/1/2024 2 a.m. PDT",880,878,314,-566
SCL,"11/1/2024 3 a.m. PDT",857,861,320,-537
SCL,"11/1/2024 4 a.m. PDT",855,865,325,-530
SCL,"11/1/2024 5 a.m. PDT",891,908,357,-534
SCL,"11/1/2024 6 a.m. PDT",972,1004,366,-606
SCL,"11/1/2024 7 a.m. PDT",1096,1144,602,-494
SCL,"11/1/2024 8 a.m. PDT",1216,1269,715,-501
SCL,"11/1/2024 9 a.m. PDT",1242,1303,692,-550
SCL,"11/1/2024 10 a.m. PDT",1281,1299,541,-740
SCL,"11/1/2024 11 a.m. PDT",1289,1285,484,-805
SCL,"11/1/2024 12 p.m. PDT",1297,1271,496,-801
SCL,"11/1/2024 1 p.m. PDT",1314,1256,485,-829
SCL,"11/1/2024 2 p.m. PDT",1298,1241,501,-797
SCL,"11/1/2024 3 p.m. PDT",1265,1221,520,-745
SCL,"11/1/2024 4 p.m. PDT",1247,1205,536,-711
SCL,"11/1/2024 5 p.m. PDT",1241,1226,635,-606
SCL,"11/1/2024 6 p.m. PDT",1256,1240,793,-463
SCL,"11/1/2024 7 p.m. PDT",1257,1247,780,-477
SCL,"11/1/2024 8 p.m. PDT",1216,1213,763,-453
SCL,"11/1/2024 9 p.m. PDT",1183,1172,693,-490
SCL,"11/1/2024 10 p.m. PDT",1139,1132,740,-399
SCL,"11/1/2024 11 p.m. PDT",1066,1070,581,-485
SCL,"11/2/2024 12 a.m. PDT",1008,1005,531,-477
SCL,"11/2/2024 1 a.m. PDT",948,921,318,-630
SCL,"11/2/2024 2 a.m. PDT",909,875,291,-618
SCL,"11/2/2024 3 a.m. PDT",885,853,269,-616
SCL,"11/2/2024 4 a.m. PDT",870,847,271,-599
SCL,"11/2/2024 5 a.m. PDT",867,866,289,-578
SCL,"11/2/2024 6 a.m. PDT",903,910,327,-576
SCL,"11/2/2024 7 a.m. PDT",955,981,514,-441
SCL,"11/2/2024 8 a.m. PDT",1017,1069,499,-518
SCL,"11/2/2024 9 a.m. PDT",1086,1127,532,-554
SCL,"11/2/2024 10 a.m. PDT",1124,1165,527,-597
SCL,"11/2/2024 11 a.m. PDT",1151,1179,523,-628
SCL,"11/2/2024 12 p.m. PDT",1145,1177,528,-617
SCL,"11/2/2024 1 p.m. PDT",1111,1161,525,-586
SCL,"11/2/2024 2 p.m. PDT",1094,1142,527,-567
SCL,"11/2/2024 3 p.m. PDT",1089,1119,527,-562
SCL,"11/2/2024 4 p.m. PDT",1100,1106,541,-559
SCL,"11/2/2024 5 p.m. PDT",1127,1129,653,-474
SCL,"11/2/2024 6 p.m. PDT",1165,1162,687,-478
SCL,"11/2/2024 7 p.m. PDT",1193,1200,700,-493
SCL,"11/2/2024 8 p.m. PDT",1144,1189,698,-446
SCL,"11/2/2024 9 p.m. PDT",1150,1168,660,-490
SCL,"11/2/2024 10 p.m. PDT",1108,1127,631,-477
SCL,"11/2/2024 11 p.m. PDT",1063,1076,520,-543
SCL,"11/3/2024 12 a.m. PDT",996,1013,440,-556
SCL,"11/3/2024 1 a.m. PDT",996,,440,
SCL,"11/3/2024 1 a.m. PST",907,,259,-648
SCL,"11/3/2024 2 a.m. PST",877,,362,-515
SCL,"11/3/2024 3 a.m. PST",867,876,278,-589
SCL,"11/3/2024 4 a.m. PST",860,857,302,-558
SCL,"11/3/2024 5 a.m. PST",872,851,310,-562
SCL,"11/3/2024 6 a.m. PST",906,864,340,-566
SCL,"11/3/2024 7 a.m. PST",958,895,420,-538
SCL,"11/3/2024 8 a.m. PST",1022,953,467,-555
SCL,"11/3/2024 9 a.m. PST",1079,1005,402,-677
SCL,"11/3/2024 10 a.m. PST",1099,1053,453,-646
SCL,"11/3/2024 11 a.m. PST",1123,1083,462,-661
SCL,"11/3/2024 12 p.m. PST",1114,1092,390,-724
SCL,"11/3/2024 1 p.m. PST",1105,1091,328,-777
SCL,"11/3/2024 2 p.m. PST",1102,1087,309,-793
SCL,"11/3/2024 3 p.m. PST",1089,1071,338,-751
SCL,"11/3/2024 4 p.m. PST",1109,1079,427,-682
SCL,"11/3/2024 5 p.m. PST",1163,1101,649,-514
SCL,"11/3/2024 6 p.m. PST",1224,1161,710,-514
SCL,"11/3/2024 7 p.m. PST",1229,1218,826,-403
SCL,"11/3/2024 8 p.m. PST",1202,1219,834,-368
SCL,"11/3/2024 9 p.m. PST",1150,1197,698,-452
SCL,"11/3/2024 10 p.m. PST",1111,1162,648,-463
SCL,"11/3/2024 11 p.m. PST",1025,1105,553,-472
SCL,"11/4/2024 12 a.m. PST",958,1039,503,-455
SCL,"11/4/2024 1 a.m. PST",915,868,423,-492
SCL,"11/4/2024 2 a.m. PST",876,843,374,-502
SCL,"11/4/2024 3 a.m. PST",872,830,383,-489
SCL,"11/4/2024 4 a.m. PST",885,839,414,-471
SCL,"11/4/2024 5 a.m. PST",920,884,452,-468
SCL,"11/4/2024 6 a.m. PST",1019,982,436,-583
SCL,"11/4/2024 7 a.m. PST",1170,1123,618,-552
SCL,"11/4/2024 8 a.m. PST",1277,1228,725,-552
SCL,"11/4/2024 9 a.m. PST",1312,1250,650,-662
SCL,"11/4/2024 10 a.m. PST",1320,1248,819,-501
SCL,"11/4/2024 11 a.m. PST",1311,1231,729,-582
SCL,"11/4/2024 12 p.m. PST",1249,1223,628,-621
SCL,"11/4/2024 1 p.m. PST",1212,1205,616,-596
SCL,"11/4/2024 2 p.m. PST",1173,1182,473,-700
SCL,"11/4/2024 3 p.m. PST",1158,1162,400,-758
SCL,"11/4/2024 4 p.m. PST",1136,1179,492,-644
SCL,"11/4/2024 5 p.m. PST",1189,1242,680,-509
SCL,"11/4/2024 6 p.m. PST",1270,1305,740,-530
SCL,"11/4/2024 7 p.m. PST",1273,1284,716,-557
SCL,"11/4/2024 8 p.m. PST",1240,1251,711,-529
SCL,"11/4/2024 9 p.m. PST",1199,1213,756,-443
SCL,"11/4/2024 10 p.m. PST",1150,1153,695,-455
SCL,"11/4/2024 11 p.m. PST",1079,1071,557,-522
SCL,"11/5/2024 12 a.m. PST",999,986,406,-593
SCL,"11/5/2024 1 a.m. PST",942,908,411,-531
SCL,"11/5/2024 2 a.m. PST",926,888,418,-508
SCL,"11/5/2024 3 a.m. PST",907,875,412,-495
SCL,"11/5/2024 4 a.m. PST",899,880,419,-480
SCL,"11/5/2024 5 a.m. PST",912,918,452,-460
SCL,"11/5/2024 6 a.m. PST",1014,1015,506,-508
SCL,"11/5/2024 7 a.m. PST",1150,1162,653,-497
SCL,"11/5/2024 8 a.m. PST",1249,1264,683,-566
SCL,"11/5/2024 9 a.m. PST",1253,1268,681,-572
SCL,"11/5/2024 10 a.m. PST",1217,1240,679,-538
SCL,"11/5/2024 11 a.m. PST",1184,1210,600,-584
SCL,"11/5/2024 12 p.m. PST",1170,1188,559,-611
SCL,"11/5/2024 1 p.m. PST",1176,1179,581,-595
SCL,"11/5/2024 2 p.m. PST",1186,1160,535,-651
SCL,"11/5/2024 3 p.m. PST",1165,1151,571,-594
SCL,"11/5/2024 4 p.m. PST",1179,1160,599,-580
SCL,"11/5/2024 5 p.m. PST",1224,1217,733,-491
SCL,"11/5/2024 6 p.m. PST",1293,1275,827,-466
SCL,"11/5/2024 7 p.m. PST",1268,1259,851,-417
SCL,"11/5/2024 8 p.m. PST",1226,1233,821,-405
SCL,"11/5/2024 9 p.m. PST",1180,1199,789,-391
SCL,"11/5/2024 10 p.m. PST",1132,1146,711,-421
SCL,"11/5/2024 11 p.m. PST",1053,1070,612,-441
SCL,"11/6/2024 12 a.m. PST",976,999,532,-444
SCL,"11/6/2024 1 a.m. PST",925,938,430,-495
SCL,"11/6/2024 2 a.m. PST",889,905,420,-469
SCL,"11/6/2024 3 a.m. PST",873,893,404,-469
SCL,"11/6/2024 4 a.m. PST",884,901,330,-554
SCL,"11/6/2024 5 a.m. PST",914,942,360,-554
SCL,"11/6/2024 6 a.m. PST",1022,1044,511,-511
SCL,"11/6/2024 7 a.m. PST",1166,1193,684,-482
SCL,"11/6/2024 8 a.m. PST",1248,1291,664,-584
SCL,"11/6/2024 9 a.m. PST",1244,1292,498,-746
SCL,"11/6/2024 10 a.m. PST",1211,1264,484,-727
SCL,"11/6/2024 11 a.m. PST",1176,1232,362,-814
SCL,"11/6/2024 12 p.m. PST",1145,1198,363,-782
SCL,"11/6/2024 1 p.m. PST",1129,1183,366,-763
SCL,"11/6/2024 2 p.m. PST",1115,1156,361,-754
SCL,"11/6/2024 3 p.m. PST",1119,1133,370,-749
SCL,"11/6/2024 4 p.m. PST",1127,1160,446,-681
SCL,"11/6/2024 5 p.m. PST",1155,1210,702,-453
SCL,"11/6/2024 6 p.m. PST",1231,1278,782,-449
SCL,"11/6/2024 7 p.m. PST",1220,1263,732,-488
SCL,"11/6/2024 8 p.m. PST",1199,1237,737,-462
SCL,"11/6/2024 9 p.m. PST",1168,1204,724,-444
SCL,"11/6/2024 10 p.m. PST",1112,1145,719,-393
SCL,"11/6/2024 11 p.m. PST",1041,1071,617,-424
SCL,"11/7/2024 12 a.m. PST",965,1007,572,-393
SCL,"11/7/2024 1 a.m. PST",921,924,282,-639
SCL,"11/7/2024 2 a.m. PST",887,889,288,-599
SCL,"11/7/2024 3 a.m. PST",882,876,285,-597
SCL,"11/7/2024 4 a.m. PST",888,883,275,-613
SCL,"11/7/2024 5 a.m. PST",931,924,322,-609
SCL,"11/7/2024 6 a.m. PST",1031,1030,482,-549
SCL,"11/7/2024 7 a.m. PST",1177,1185,529,-648
SCL,"11/7/2024 8 a.m. PST",1272,1282,669,-603
SCL,"11/7/2024 9 a.m. PST",1264,1286,769,-495
SCL,"11/7/2024 10 a.m. PST",1218,1254,657,-561
SCL,"11/7/2024 11 a.m. PST",1181,1221,698,-483
SCL,"11/7/2024 12 p.m. PST",1160,1186,578,-582
SCL,"11/7/2024 1 p.m. PST",1133,1165,426,-707
SCL,"11/7/2024 2 p.m. PST",1113,1136,430,-683
SCL,"11/7/2024 3 p.m. PST",1102,1118,383,-719
SCL,"11/7/2024 4 p.m. PST",1120,1125,489,-631
SCL,"11/7/2024 5 p.m. PST",1154,1184,644,-510
SCL,"11/7/2024 6 p.m. PST",1208,1242,693,-515
SCL,"11/7/2024 7 p.m. PST",1200,1228,685,-515
SCL,"11/7/2024 8 p.m. PST",1166,1204,669,-497
SCL,"11/7/2024 9 p.m. PST",1137,1172,599,-538
SCL,"11/7/2024 10 p.m. PST",1076,1116,561,-515
SCL,"11/7/2024 11 p.m. PST",1002,1040,489,-513
SCL,"11/8/2024 12 a.m. PST",924,975,456,-468
SCL,"11/8/2024 1 a.m. PST",879,883,321,-558
SCL,"11/8/2024 2 a.m. PST",839,845,271,-568
SCL,"11/8/2024 3 a.m. PST",826,828,269,-557
SCL,"11/8/2024 4 a.m. PST",823,831,270,-553
SCL,"11/8/2024 5 a.m. PST",858,872,311,-547
SCL,"11/8/2024 6 a.m. PST",946,968,486,-460
SCL,"11/8/2024 7 a.m. PST",1077,1115,486,-591
SCL,"11/8/2024 8 a.m. PST",1172,1218,477,-695
SCL,"11/8/2024 9 a.m. PST",1213,1233,471,-742
SCL,"11/8/2024 10 a.m. PST",1199,1217,424,-775
SCL,"11/8/2024 11 a.m. PST",1190,1194,419,-771
SCL,"11/8/2024 12 p.m. PST",1156,1172,426,-730
SCL,"11/8/2024 1 p.m. PST",1131,1165,419,-712
SCL,"11/8/2024 2 p.m. PST",1142,1160,406,-736
SCL,"11/8/2024 3 p.m. PST",1126,1150,406,-720
SCL,"11/8/2024 4 p.m. PST",1133,1158,530,-603
SCL,"11/8/2024 5 p.m. PST",1171,1190,760,-411
SCL,"11/8/2024 6 p.m. PST",1217,1223,771,-446
SCL,"11/8/2024 7 p.m. PST",1177,1199,786,-391
SCL,"11/8/2024 8 p.m. PST",1147,1155,753,-394
SCL,"11/8/2024 9 p.m. PST",1114,1119,793,-321
SCL,"11/8/2024 10 p.m. PST",1062,1071,642,-420
SCL,"11/8/2024 11 p.m. PST",1009,1016,465,-544
SCL,"11/9/2024 12 a.m. PST",958,960,460,-498
SCL,"11/9/2024 1 a.m. PST",912,877,474,-438
SCL,"11/9/2024 2 a.m. PST",869,837,430,-439
SCL,"11/9/2024 3 a.m. PST",849,816,431,-418
SCL,"11/9/2024 4 a.m. PST",845,810,420,-425
SCL,"11/9/2024 5 a.m. PST",850,822,433,-417
SCL,"11/9/2024 6 a.m. PST",888,863,445,-443
SCL,"11/9/2024 7 a.m. PST",933,929,489,-444
SCL,"11/9/2024 8 a.m. PST",1001,983,473,-528
SCL,"11/9/2024 9 a.m. PST",1057,1030,446,-611
SCL,"11/9/2024 10 a.m. PST",1101,1062,446,-655
SCL,"11/9/2024 11 a.m. PST",1125,1073,478,-647
SCL,"11/9/2024 12 p.m. PST",1140,1070,487,-653
SCL,"11/9/2024 1 p.m. PST",1140,1056,472,-668
SCL,"11/9/2024 2 p.m. PST",1144,1039,474,-670
SCL,"11/9/2024 3 p.m. PST",1145,1047,488,-657
SCL,"11/9/2024 4 p.m. PST",1152,1063,622,-530
SCL,"11/9/2024 5 p.m. PST",1183,1101,880,-303
SCL,"11/9/2024 6 p.m. PST",1198,1141,897,-301
SCL,"11/9/2024 7 p.m. PST",1177,1133,869,-308
SCL,"11/9/2024 8 p.m. PST",1103,1106,802,-301
SCL,"11/9/2024 9 p.m. PST",1109,1085,851,-258
SCL,"11/9/2024 10 p.m. PST",1067,1047,661,-406
SCL,"11/9/2024 11 p.m. PST",1000,998,548,-452
SCL,"11/10/2024 12 a.m. PST",945,949,455,-490
SCL,"11/10/2024 1 a.m. PST",904,885,309,-595
SCL,"11/10/2024 2 a.m. PST",888,845,294,-594
SCL,"11/10/2024 3 a.m. PST",851,823,296,-555
SCL,"11/10/2024 4 a.m. PST",851,815,292,-559
SCL,"11/10/2024 5 a.m. PST",853,824,294,-559
SCL,"11/10/2024 6 a.m. PST",867,857,343,-524
SCL,"11/10/2024 7 a.m. PST",915,913,380,-535
SCL,"11/10/2024 8 a.m. PST",964,964,374,-590
SCL,"11/10/2024 9 a.m. PST",1026,1012,398,-628
SCL,"11/10/2024 10 a.m. PST",1067,1041,407,-660
SCL,"11/10/2024 11 a.m. PST",1075,1053,369,-706
SCL,"11/10/2024 12 p.m. PST",1066,1048,371,-695
SCL,"11/10/2024 1 p.m. PST",1078,1045,370,-708
SCL,"11/10/2024 2 p.m. PST",1074,1030,364,-710
SCL,"11/10/2024 3 p.m. PST",1085,1031,375,-710
SCL,"11/10/2024 4 p.m. PST",1104,1047,483,-621
SCL,"11/10/2024 5 p.m. PST",1134,1103,903,-231
SCL,"11/10/2024 6 p.m. PST",1140,1160,875,-265
SCL,"11/10/2024 7 p.m. PST",1134,1153,869,-265
SCL,"11/10/2024 8 p.m. PST",1103,1131,836,-267
SCL,"11/10/2024 9 p.m. PST",1074,1103,639,-435
SCL,"11/10/2024 10 p.m. PST",1028,1050,600,-428
SCL,"11/10/2024 11 p.m. PST",1027,983,572,-455
SCL,"11/11/2024 12 a.m. PST",953,912,425,-528
SCL,"11/11/2024 1 a.m. PST",911,869,275,-636
SCL,"11/11/2024 2 a.m. PST",875,844,274,-601
SCL,"11/11/2024 3 a.m. PST",863,829,311,-552
SCL,"11/11/2024 4 a.m. PST",868,836,318,-550
SCL,"11/11/2024 5 a.m. PST",893,870,306,-587
SCL,"11/11/2024 6 a.m. PST",974,957,343,-631
SCL,"11/11/2024 7 a.m. PST",1068,1079,457,-611
SCL,"11/11/2024 8 a.m. PST",1145,1178,667,-478
SCL,"11/11/2024 9 a.m. PST",1194,1222,712,-482
SCL,"11/11/2024 10 a.m. PST",1197,1243,700,-497
SCL,"11/11/2024 11 a.m. PST",1166,1243,487,-679
SCL,"11/11/2024 12 p.m. PST",1194,1249,489,-705
SCL,"11/11/2024 1 p.m. PST",1201,1241,426,-775
SCL,"11/11/2024 2 p.m. PST",1200,1231,393,-807
SCL,"11/11/2024 3 p.m. PST",1180,1229,377,-803
SCL,"11/11/2024 4 p.m. PST",1173,1242,412,-761
SCL,"11/11/2024 5 p.m. PST",1236,1278,570,-666
SCL,"11/11/2024 6 p.m. PST",1284,1336,631,-653
SCL,"11/11/2024 7 p.m. PST",1261,1298,703,-558
SCL,"11/11/2024 8 p.m. PST",1222,1252,759,-463
SCL,"11/11/2024 9 p.m. PST",1187,1201,715,-472
SCL,"11/11/2024 10 p.m. PST",1127,1137,507,-620
SCL,"11/11/2024 11 p.m. PST",1041,1048,447,-594
SCL,"11/12/2024 12 a.m. PST",961,964,390,-571
SCL,"11/12/2024 1 a.m. PST",910,924,205,-705
SCL,"11/12/2024 2 a.m. PST",872,877,201,-671
SCL,"11/12/2024 3 a.m. PST",855,861,190,-665
SCL,"11/12/2024 4 a.m. PST",861,863,262,-599
SCL,"11/12/2024 5 a.m. PST",896,898,259,-637
SCL,"11/12/2024 6 a.m. PST",981,990,368,-613
SCL,"11/12/2024 7 a.m. PST",1119,1136,500,-619
SCL,"11/12/2024 8 a.m. PST",1233,1239,596,-637
SCL,"11/12/2024 9 a.m. PST",1232,1249,565,-667
SCL,"11/12/2024 10 a.m. PST",1216,1229,582,-634
SCL,"11/12/2024 11 a.m. PST",1184,1204,493,-691
SCL,"11/12/2024 12 p.m. PST",1172,1179,486,-686
SCL,"11/12/2024 1 p.m. PST",1185,1168,473,-712
SCL,"11/12/2024 2 p.m. PST",1186,1150,472,-714
SCL,"11/12/2024 3 p.m. PST",1183,1136,485,-698
SCL,"11/12/2024 4 p.m. PST",1191,1153,635,-556
SCL,"11/12/2024 5 p.m. PST",1235,1211,781,-454
SCL,"11/12/2024 6 p.m. PST",1268,1261,770,-498
SCL,"11/12/2024 7 p.m. PST",1255,1239,747,-508
SCL,"11/12/2024 8 p.m. PST",1223,1207,607,-616
SCL,"11/12/2024 9 p.m. PST",1188,1167,629,-559
SCL,"11/12/2024 10 p.m. PST",1125,1115,482,-643
SCL,"11/12/2024 11 p.m. PST",1046,1034,300,-746
SCL,"11/13/2024 12 a.m. PST",963,960,271,-692
SCL,"11/13/2024 1 a.m. PST",908,910,235,-673
SCL,"11/13/2024 2 a.m. PST",869,874,211,-658
SCL,"11/13/2024 3 a.m. PST",850,855,192,-658
SCL,"11/13/2024 4 a.m. PST",844,855,184,-660
SCL,"11/13/2024 5 a.m. PST",880,887,253,-627
SCL,"11/13/2024 6 a.m. PST",972,976,308,-664
SCL,"11/13/2024 7 a.m. PST",1110,1113,427,-683
SCL,"11/13/2024 8 a.m. PST",1203,1205,381,-822
SCL,"11/13/2024 9 a.m. PST",1211,1221,381,-830
SCL,"11/13/2024 10 a.m. PST",1222,1214,360,-862
SCL,"11/13/2024 11 a.m. PST",1220,1197,369,-851
SCL,"11/13/2024 12 p.m. PST",1206,1181,355,-851
SCL,"11/13/2024 1 p.m. PST",1210,1182,499,-711
SCL,"11/13/2024 2 p.m. PST",1191,1171,519,-672
SCL,"11/13/2024 3 p.m. PST",1172,1160,536,-636
SCL,"11/13/2024 4 p.m. PST",1203,1179,638,-565
SCL,"11/13/2024 5 p.m. PST",1253,1230,642,-611
SCL,"11/13/2024 6 p.m. PST",1283,1270,632,-651
SCL,"11/13/2024 7 p.m. PST",1257,1251,627,-630
SCL,"11/13/2024 8 p.m. PST",1226,1217,628,-598
SCL,"11/13/2024 9 p.m. PST",1188,1175,598,-590
SCL,"11/13/2024 10 p.m. PST",1131,1117,554,-577
SCL,"11/13/2024 11 p.m. PST",1046,1036,389,-657
SCL,"11/14/2024 12 a.m. PST",964,965,403,-561
SCL,"11/14/2024 1 a.m. PST",909,916,275,-634
SCL,"11/14/2024 2 a.m. PST",871,881,261,-610
SCL,"11/14/2024 3 a.m. PST",858,863,220,-638
SCL,"11/14/2024 4 a.m. PST",856,863,146,-710
SCL,"11/14/2024 5 a.m. PST",896,891,204,-692
SCL,"11/14/2024 6 a.m. PST",984,977,384,-600
SCL,"11/14/2024 7 a.m. PST",1114,1115,377,-737
SCL,"11/14/2024 8 a.m. PST",1212,1213,374,-838
SCL,"11/14/2024 9 a.m. PST",1231,1228,384,-847
SCL,"11/14/2024 10 a.m. PST",1229,1222,495,-734
SCL,"11/14/2024 11 a.m. PST",1228,1211,416,-812
SCL,"11/14/2024 12 p.m. PST",1236,1199,368,-868
SCL,"11/14/2024 1 p.m. PST",1240,1200,290,-950
SCL,"11/14/2024 2 p.m. PST",1240,1195,298,-942
SCL,"11/14/2024 3 p.m. PST",1233,1191,307,-926
SCL,"11/14/2024 4 p.m. PST",1218,1203,376,-842
SCL,"11/14/2024 5 p.m. PST",1269,1264,564,-705
SCL,"11/14/2024 6 p.m. PST",1311,1307,591,-720
SCL,"11/14/2024 7 p.m. PST",1291,1276,569,-722
SCL,"11/14/2024 8 p.m. PST",1265,1240,603,-662
SCL,"11/14/2024 9 p.m. PST",1232,1204,606,-626
SCL,"11/14/2024 10 p.m. PST",1173,1146,381,-792
SCL,"11/14/2024 11 p.m. PST",1090,1072,368,-722
SCL,"11/15/2024 12 a.m. PST",1016,998,192,-824
SCL,"11/15/2024 1 a.m. PST",955,970,87,-868
SCL,"11/15/2024 2 a.m. PST",919,934,98,-821
SCL,"11/15/2024 3 a.m. PST",901,918,101,-800
SCL,"11/15/2024 4 a.m. PST",899,921,104,-795
SCL,"11/15/2024 5 a.m. PST",945,959,197,-748
SCL,"11/15/2024 6 a.m. PST",1026,1053,425,-601
SCL,"11/15/2024 7 a.m. PST",1169,1193,401,-768
SCL,"11/15/2024 8 a.m. PST",1270,1294,370,-900
SCL,"11/15/2024 9 a.m. PST",1298,1320,421,-877
SCL,"11/15/2024 10 a.m. PST",1318,1306,273,-1045
SCL,"11/15/2024 11 a.m. PST",1293,1279,272,-1021
SCL,"11/15/2024 12 p.m. PST",1284,1258,269,-1015
SCL,"11/15/2024 1 p.m. PST",1265,1246,270,-995
SCL,"11/15/2024 2 p.m. PST",1240,1232,267,-973
SCL,"11/15/2024 3 p.m. PST",1227,1224,277,-950
SCL,"11/15/2024 4 p.m. PST",1240,1237,404,-836
SCL,"11/15/2024 5 p.m. PST",1302,1280,571,-731
SCL,"11/15/2024 6 p.m. PST",1356,1313,598,-758
SCL,"11/15/2024 7 p.m. PST",1322,1286,586,-736
SCL,"11/15/2024 8 p.m. PST",1289,1245,563,-726
SCL,"11/15/2024 9 p.m. PST",1251,1203,418,-833
SCL,"11/15/2024 10 p.m. PST",1207,1158,405,-802
SCL,"11/15/2024 11 p.m. PST",249,1102,313,64
SCL,"11/16/2024 12 a.m. PST",1096,1041,161,-935
SCL,"11/16/2024 1 a.m. PST",1044,1028,150,-894
SCL,"11/16/2024 2 a.m. PST",1012,982,149,-863
SCL,"11/16/2024 3 a.m. PST",995,964,125,-870
SCL,"11/16/2024 4 a.m. PST",991,962,129,-862
SCL,"11/16/2024 5 a.m. PST",1007,979,129,-878
SCL,"11/16/2024 6 a.m. PST",1042,1025,141,-901
SCL,"11/16/2024 7 a.m. PST",1107,1094,334,-773
SCL,"11/16/2024 8 a.m. PST",1168,1161,316,-852
SCL,"11/16/2024 9 a.m. PST",1226,1215,330,-896
SCL,"11/16/2024 10 a.m. PST",1279,1240,338,-941
SCL,"11/16/2024 11 a.m. PST",1298,1238,304,-994
SCL,"11/16/2024 12 p.m. PST",1308,1222,308,-1000
SCL,"11/16/2024 1 p.m. PST",1333,1207,318,-1015
SCL,"11/16/2024 2 p.m. PST",1329,1192,349,-980
SCL,"11/16/2024 3 p.m. PST",1310,1193,358,-952
SCL,"11/16/2024 4 p.m. PST",1330,1202,528,-802
SCL,"11/16/2024 5 p.m. PST",1344,1247,623,-721
SCL,"11/16/2024 6 p.m. PST",1354,1281,638,-716
SCL,"11/16/2024 7 p.m. PST",1308,1268,609,-699
SCL,"11/16/2024 8 p.m. PST",1293,1238,574,-719
SCL,"11/16/2024 9 p.m. PST",1244,1206,374,-870
SCL,"11/16/2024 10 p.m. PST",1212,1161,350,-862
SCL,"11/16/2024 11 p.m. PST",1152,1100,235,-917
SCL,"11/17/2024 12 a.m. PST",1075,1031,253,-822
SCL,"11/17/2024 1 a.m. PST",984,1007,157,-827
SCL,"11/17/2024 2 a.m. PST",977,957,125,-852
SCL,"11/17/2024 3 a.m. PST",953,933,121,-832
SCL,"11/17/2024 4 a.m. PST",930,925,117,-813
SCL,"11/17/2024 5 a.m. PST",931,934,127,-804
SCL,"11/17/2024 6 a.m. PST",959,965,224,-735
SCL,"11/17/2024 7 a.m. PST",1008,1026,212,-796
SCL,"11/17/2024 8 a.m. PST",1056,1094,199,-857
SCL,"11/17/2024 9 a.m. PST",1111,1156,114,-997
SCL,"11/17/2024 10 a.m. PST",1158,1211,112,-1046
SCL,"11/17/2024 11 a.m. PST",1185,1236,110,-1075
SCL,"11/17/2024 12 p.m. PST",1215,1239,110,-1105
SCL,"11/17/2024 1 p.m. PST",1249,1250,111,-1138
SCL,"11/17/2024 2 p.m. PST",1226,1250,124,-1102
SCL,"11/17/2024 3 p.m. PST",1244,1258,225,-1019
SCL,"11/17/2024 4 p.m. PST",1274,1277,354,-920
SCL,"11/17/2024 5 p.m. PST",1314,1336,529,-785
SCL,"11/17/2024 6 p.m. PST",1354,1397,527,-827
SCL,"11/17/2024 7 p.m. PST",1354,1390,512,-842
SCL,"11/17/2024 8 p.m. PST",1338,1365,463,-875
SCL,"11/17/2024 9 p.m. PST",1299,1323,433,-866
SCL,"11/17/2024 10 p.m. PST",1254,1260,374,-880
SCL,"11/17/2024 11 p.m. PST",1181,1189,269,-912
SCL,"11/18/2024 12 a.m. PST",1096,1102,179,-917
SCL,"11/18/2024 1 a.m. PST",1040,1018,150,-890
SCL,"11/18/2024 2 a.m. PST",1009,981,124,-885
SCL,"11/18/2024 3 a.m. PST",997,972,125,-872
SCL,"11/18/2024 4 a.m. PST",1002,984,142,-860
SCL,"11/18/2024 5 a.m. PST",1056,1028,182,-874
SCL,"11/18/2024 6 a.m. PST",1155,1128,287,-868
SCL,"11/18/2024 7 a.m. PST",1314,1270,430,-884
SCL,"11/18/2024 8 a.m. PST",1420,1377,475,-945
SCL,"11/18/2024 9 a.m. PST",1442,1401,548,-894
SCL,"11/18/2024 10 a.m. PST",1428,1391,301,-1127
SCL,"11/18/2024 11 a.m. PST",1451,1370,311,-1140
SCL,"11/18/2024 12 p.m. PST",1452,1351,292,-1160
SCL,"11/18/2024 1 p.m. PST",1438,1335,296,-1142
SCL,"11/18/2024 2 p.m. PST",1383,1322,291,-1092
SCL,"11/18/2024 3 p.m. PST",1385,1312,288,-1097
SCL,"11/18/2024 4 p.m. PST",1413,1326,464,-949
SCL,"11/18/2024 5 p.m. PST",1471,1391,558,-913
SCL,"11/18/2024 6 p.m. PST",1527,1436,681,-846
SCL,"11/18/2024 7 p.m. PST",1490,1412,640,-850
SCL,"11/18/2024 8 p.m. PST",1451,1369,615,-836
SCL,"11/18/2024 9 p.m. PST",1402,1326,639,-763
SCL,"11/18/2024 10 p.m. PST",1334,1270,555,-779
SCL,"11/18/2024 11 p.m. PST",1243,1179,410,-833
SCL,"11/19/2024 12 a.m. PST",1151,1093,244,-907
SCL,"11/19/2024 1 a.m. PST",1093,1065,85,-1008
SCL,"11/19/2024 2 a.m. PST",1064,1016,86,-978
SCL,"11/19/2024 3 a.m. PST",1063,1002,86,-977
SCL,"11/19/2024 4 a.m. PST",1074,1010,93,-981
SCL,"11/19/2024 5 a.m. PST",1066,1052,97,-969
SCL,"11/19/2024 6 a.m. PST",1161,1154,357,-804
SCL,"11/19/2024 7 a.m. PST",1321,1306,579,-742
SCL,"11/19/2024 8 a.m. PST",1421,1424,654,-767
SCL,"11/19/2024 9 a.m. PST",1415,1429,652,-763
SCL,"11/19/2024 10 a.m. PST",1391,1405,514,-877
SCL,"11/19/2024 11 a.m. PST",1381,1372,439,-942
SCL,"11/19/2024 12 p.m. PST",1383,1339,293,-1090
SCL,"11/19/2024 1 p.m. PST",1381,1320,296,-1085
SCL,"11/19/2024 2 p.m. PST",1375,1301,349,-1026
SCL,"11/19/2024 3 p.m. PST",1369,1285,504,-865
SCL,"11/19/2024 4 p.m. PST",1388,1303,624,-764
SCL,"11/19/2024 5 p.m. PST",246,1359,701,455
SCL,"11/19/2024 6 p.m. PST",1467,1403,689,-778
SCL,"11/19/2024 7 p.m. PST",1373,1380,587,-786
SCL,"11/19/2024 8 p.m. PST",1241,1339,503,-738
SCL,"11/19/2024 9 p.m. PST",1120,1297,468,-652
SCL,"11/19/2024 10 p.m. PST",1036,1236,362,-674
SCL,"11/19/2024 11 p.m. PST",915,1149,186,-729
SCL,"11/20/2024 12 a.m. PST",856,1069,80,-776
SCL,"11/20/2024 1 a.m. PST",826,819,92,-734
SCL,"11/20/2024 2 a.m. PST",803,804,95,-708
SCL,"11/20/2024 3 a.m. PST",822,789,133,-689
SCL,"11/20/2024 4 a.m. PST",836,808,129,-707
SCL,"11/20/2024 5 a.m. PST",878,878,143,-735
SCL,"11/20/2024 6 a.m. PST",984,1002,219,-765
SCL,"11/20/2024 7 a.m. PST",1121,1177,597,-524
SCL,"11/20/2024 8 a.m. PST",1229,1318,570,-659
SCL,"11/20/2024 9 a.m. PST",1273,1356,538,-735
SCL,"11/20/2024 10 a.m. PST",1269,1335,533,-736
SCL,"11/20/2024 11 a.m. PST",1240,1307,455,-785
SCL,"11/20/2024 12 p.m. PST",1234,1283,412,-822
SCL,"11/20/2024 1 p.m. PST",1246,1273,445,-801
SCL,"11/20/2024 2 p.m. PST",1249,1259,414,-835
SCL,"11/20/2024 3 p.m. PST",1256,1247,456,-800
SCL,"11/20/2024 4 p.m. PST",1267,1268,485,-782
SCL,"11/20/2024 5 p.m. PST",1317,1328,640,-677
SCL,"11/20/2024 6 p.m. PST",1353,1370,582,-771
SCL,"11/20/2024 7 p.m. PST",1334,1349,553,-781
SCL,"11/20/2024 8 p.m. PST",1301,1314,495,-806
SCL,"11/20/2024 9 p.m. PST",1254,1276,523,-731
SCL,"11/20/2024 10 p.m. PST",1194,1216,376,-818
SCL,"11/20/2024 11 p.m. PST",1118,1136,265,-853
SCL,"11/21/2024 12 a.m. PST",1042,1060,259,-783
SCL,"11/21/2024 1 a.m. PST",980,994,107,-873
SCL,"11/21/2024 2 a.m. PST",933,968,96,-837
SCL,"11/21/2024 3 a.m. PST",921,953,99,-822
SCL,"11/21/2024 4 a.m. PST",926,955,90,-836
SCL,"11/21/2024 5 a.m. PST",968,985,107,-861
SCL,"11/21/2024 6 a.m. PST",1059,1079,435,-624
SCL,"11/21/2024 7 a.m. PST",1208,1221,504,-704
SCL,"11/21/2024 8 a.m. PST",1313,1312,660,-653
SCL,"11/21/2024 9 a.m. PST",1320,1312,673,-647
SCL,"11/21/2024 10 a.m. PST",1303,1294,576,-727
SCL,"11/21/2024 11 a.m. PST",1283,1273,348,-935
SCL,"11/21/2024 12 p.m. PST",1242,1253,273,-969
SCL,"11/21/2024 1 p.m. PST",1234,1249,317,-917
SCL,"11/21/2024 2 p.m. PST",1246,1228,318,-928
SCL,"11/21/2024 3 p.m. PST",1257,1214,369,-888
SCL,"11/21/2024 4 p.m. PST",1269,1232,480,-789
SCL,"11/21/2024 5 p.m. PST",1308,1294,500,-808
SCL,"11/21/2024 6 p.m. PST",1341,1329,536,-805
SCL,"11/21/2024 7 p.m. PST",1317,1301,548,-769
SCL,"11/21/2024 8 p.m. PST",1283,1266,547,-736
SCL,"11/21/2024 9 p.m. PST",1249,1231,528,-721
SCL,"11/21/2024 10 p.m. PST",1195,1174,361,-834
SCL,"11/21/2024 11 p.m. PST",1112,1099,236,-876
SCL,"11/22/2024 12 a.m. PST",1031,1024,164,-867
SCL,"11/22/2024 1 a.m. PST",969,994,88,-881
SCL,"11/22/2024 2 a.m. PST",930,949,85,-845
SCL,"11/22/2024 3 a.m. PST",904,931,80,-824
SCL,"11/22/2024 4 a.m. PST",910,933,80,-830
SCL,"11/22/2024 5 a.m. PST",947,967,137,-810
SCL,"11/22/2024 6 a.m. PST",1036,1055,214,-822
SCL,"11/22/2024 7 a.m. PST",1166,1181,418,-748
SCL,"11/22/2024 8 a.m. PST",1264,1275,440,-824
SCL,"11/22/2024 9 a.m. PST",1293,1301,442,-851
SCL,"11/22/2024 10 a.m. PST",1327,1291,442,-885
SCL,"11/22/2024 11 a.m. PST",1347,1267,341,-1006
SCL,"11/22/2024 12 p.m. PST",1291,1241,429,-862
SCL,"11/22/2024 1 p.m. PST",1257,1223,342,-915
SCL,"11/22/2024 2 p.m. PST",1241,1207,314,-927
SCL,"11/22/2024 3 p.m. PST",1220,1189,367,-853
SCL,"11/22/2024 4 p.m. PST",1248,1205,554,-694
SCL,"11/22/2024 5 p.m. PST",1296,1254,511,-785
SCL,"11/22/2024 6 p.m. PST",1335,1289,523,-812
SCL,"11/22/2024 7 p.m. PST",1291,1263,537,-754
SCL,"11/22/2024 8 p.m. PST",1247,1219,492,-755
SCL,"11/22/2024 9 p.m. PST",1206,1183,476,-730
SCL,"11/22/2024 10 p.m. PST",1164,1134,414,-750
SCL,"11/22/2024 11 p.m. PST",1087,1077,349,-738
SCL,"11/23/2024 12 a.m. PST",1029,1019,292,-737
SCL,"11/23/2024 1 a.m. PST",996,963,135,-861
SCL,"11/23/2024 2 a.m. PST",950,924,82,-868
SCL,"11/23/2024 3 a.m. PST",933,904,85,-848
SCL,"11/23/2024 4 a.m. PST",934,898,97,-837
SCL,"11/23/2024 5 a.m. PST",944,908,91,-853
SCL,"11/23/2024 6 a.m. PST",987,946,152,-835
SCL,"11/23/2024 7 a.m. PST",1045,1007,341,-704
SCL,"11/23/2024 8 a.m. PST",1097,1068,355,-742
SCL,"11/23/2024 9 a.m. PST",1172,1125,378,-794
SCL,"11/23/2024 10 a.m. PST",1191,1159,352,-839
SCL,"11/23/2024 11 a.m. PST",1186,1172,371,-815
SCL,"11/23/2024 12 p.m. PST",1193,1171,314,-879
SCL,"11/23/2024 1 p.m. PST",1210,1165,355,-855
SCL,"11/23/2024 2 p.m. PST",1213,1145,360,-853
SCL,"11/23/2024 3 p.m. PST",1198,1144,345,-853
SCL,"11/23/2024 4 p.m. PST",1194,1157,373,-821
SCL,"11/23/2024 5 p.m. PST",1255,1197,429,-826
SCL,"11/23/2024 6 p.m. PST",1294,1234,545,-749
SCL,"11/23/2024 7 p.m. PST",1288,1230,530,-758
SCL,"11/23/2024 8 p.m. PST",1257,1206,541,-716
SCL,"11/23/2024 9 p.m. PST",1197,1184,517,-680
SCL,"11/23/2024 10 p.m. PST",1183,1147,439,-744
SCL,"11/23/2024 11 p.m. PST",1139,1094,336,-803
SCL,"11/24/2024 12 a.m. PST",1077,1041,218,-859
SCL,"11/24/2024 1 a.m. PST",1012,997,242,-770
SCL,"11/24/2024 2 a.m. PST",943,963,86,-857
SCL,"11/24/2024 3 a.m. PST",922,945,93,-829
SCL,"11/24/2024 4 a.m. PST",912,938,86,-826
SCL,"11/24/2024 5 a.m. PST",917,946,91,-826
SCL,"11/24/2024 6 a.m. PST",954,978,161,-793
SCL,"11/24/2024 7 a.m. PST",998,1029,205,-793
SCL,"11/24/2024 8 a.m. PST",1052,1086,317,-735
SCL,"11/24/2024 9 a.m. PST",1112,1135,355,-757
SCL,"11/24/2024 10 a.m. PST",1167,1170,398,-769
SCL,"11/24/2024 11 a.m. PST",1194,1181,419,-775
SCL,"11/24/2024 12 p.m. PST",1209,1178,330,-879
SCL,"11/24/2024 1 p.m. PST",1213,1185,332,-881
SCL,"11/24/2024 2 p.m. PST",1219,1179,336,-883
SCL,"11/24/2024 3 p.m. PST",1213,1171,385,-828
SCL,"11/24/2024 4 p.m. PST",1215,1190,585,-630
SCL,"11/24/2024 5 p.m. PST",1270,1247,742,-528
SCL,"11/24/2024 6 p.m. PST",1307,1300,787,-520
SCL,"11/24/2024 7 p.m. PST",1287,1292,788,-499
SCL,"11/24/2024 8 p.m. PST",1256,1270,727,-529
SCL,"11/24/2024 9 p.m. PST",1225,1234,651,-574
SCL,"11/24/2024 10 p.m. PST",1173,1175,479,-694
SCL,"11/24/2024 11 p.m. PST",1094,1100,470,-624
SCL,"11/25/2024 12 a.m. PST",1019,1032,318,-701
SCL,"11/25/2024 1 a.m. PST",965,971,276,-689
SCL,"11/25/2024 2 a.m. PST",929,943,115,-814
SCL,"11/25/2024 3 a.m. PST",922,932,95,-827
SCL,"11/25/2024 4 a.m. PST",932,944,95,-837
SCL,"11/25/2024 5 a.m. PST",979,993,235,-744
SCL,"11/25/2024 6 a.m. PST",1072,1095,345,-727
SCL,"11/25/2024 7 a.m. PST",1206,1238,519,-687
SCL,"11/25/2024 8 a.m. PST",1304,1352,598,-706
SCL,"11/25/2024 9 a.m. PST",1334,1376,526,-808
SCL,"11/25/2024 10 a.m. PST",1341,1368,495,-846
SCL,"11/25/2024 11 a.m. PST",1340,1348,418,-922
SCL,"11/25/2024 12 p.m. PST",1339,1330,364,-975
SCL,"11/25/2024 1 p.m. PST",1313,1315,362,-951
SCL,"11/25/2024 2 p.m. PST",1299,1303,359,-940
SCL,"11/25/2024 3 p.m. PST",1298,1280,371,-927
SCL,"11/25/2024 4 p.m. PST",1298,1305,513,-785
SCL,"11/25/2024 5 p.m. PST",1348,1354,694,-654
SCL,"11/25/2024 6 p.m. PST",1372,1407,655,-717
SCL,"11/25/2024 7 p.m. PST",1336,1377,654,-682
SCL,"11/25/2024 8 p.m. PST",1298,1336,616,-682
SCL,"11/25/2024 9 p.m. PST",1260,1300,590,-670
SCL,"11/25/2024 10 p.m. PST",1195,1238,562,-633
SCL,"11/25/2024 11 p.m. PST",1112,1148,421,-691
SCL,"11/26/2024 12 a.m. PST",1033,1061,306,-727
SCL,"11/26/2024 1 a.m. PST",975,985,138,-837
SCL,"11/26/2024 2 a.m. PST",938,952,119,-819
SCL,"11/26/2024 3 a.m. PST",922,938,92,-830
SCL,"11/26/2024 4 a.m. PST",924,945,85,-839
SCL,"11/26/2024 5 a.m. PST",970,987,103,-867
SCL,"11/26/2024 6 a.m. PST",1071,1087,338,-733
SCL,"11/26/2024 7 a.m. PST",1199,1236,634,-565
SCL,"11/26/2024 8 a.m. PST",1306,1349,644,-662
SCL,"11/26/2024 9 a.m. PST",1334,1366,661,-673
SCL,"11/26/2024 10 a.m. PST",1335,1354,566,-769
SCL,"11/26/2024 11 a.m. PST",1331,1331,416,-915
SCL,"11/26/2024 12 p.m. PST",1302,1312,355,-947
SCL,"11/26/2024 1 p.m. PST",1302,1310,357,-945
SCL,"11/26/2024 2 p.m. PST",1306,1291,376,-930
SCL,"11/26/2024 3 p.m. PST",1296,1290,387,-909
SCL,"11/26/2024 4 p.m. PST",1304,1302,420,-884
SCL,"11/26/2024 5 p.m. PST",1343,1346,587,-756
SCL,"11/26/2024 6 p.m. PST",1381,1394,616,-765
SCL,"11/26/2024 7 p.m. PST",1338,1374,557,-781
SCL,"11/26/2024 8 p.m. PST",1311,1338,583,-728
SCL,"11/26/2024 9 p.m. PST",1274,1293,553,-721
SCL,"11/26/2024 10 p.m. PST",1222,1231,602,-620
SCL,"11/26/2024 11 p.m. PST",1138,1143,476,-662
SCL,"11/27/2024 12 a.m. PST",1058,1068,292,-766
SCL,"11/27/2024 1 a.m. PST",1000,1006,140,-860
SCL,"11/27/2024 2 a.m. PST",959,972,94,-865
SCL,"11/27/2024 3 a.m. PST",939,957,90,-849
SCL,"11/27/2024 4 a.m. PST",943,963,87,-856
SCL,"11/27/2024 5 a.m. PST",983,1005,132,-851
SCL,"11/27/2024 6 a.m. PST",1073,1105,273,-800
SCL,"11/27/2024 7 a.m. PST",1202,1253,632,-570
SCL,"11/27/2024 8 a.m. PST",1299,1371,677,-622
SCL,"11/27/2024 9 a.m. PST",1337,1390,677,-660
SCL,"11/27/2024 10 a.m. PST",1332,1372,623,-709
SCL,"11/27/2024 11 a.m. PST",1309,1355,395,-914
SCL,"11/27/2024 12 p.m. PST",1291,1338,384,-907
SCL,"11/27/2024 1 p.m. PST",1269,1336,374,-895
SCL,"11/27/2024 2 p.m. PST",1251,1325,367,-884
SCL,"11/27/2024 3 p.m. PST",1245,1314,367,-878
SCL,"11/27/2024 4 p.m. PST",1263,1337,430,-833
SCL,"11/27/2024 5 p.m. PST",1318,1379,629,-689
SCL,"11/27/2024 6 p.m. PST",1358,1424,658,-700
SCL,"11/27/2024 7 p.m. PST",1324,1400,640,-684
SCL,"11/27/2024 8 p.m. PST",1293,1366,616,-677
SCL,"11/27/2024 9 p.m. PST",1265,1321,552,-713
SCL,"11/27/2024 10 p.m. PST",1219,1264,560,-659
SCL,"11/27/2024 11 p.m. PST",1159,1182,504,-655
SCL,"11/28/2024 12 a.m. PST",1096,1099,355,-741
SCL,"11/28/2024 1 a.m. PST",1042,1040,84,-958
SCL,"11/28/2024 2 a.m. PST",1006,1016,87,-919
SCL,"11/28/2024 3 a.m. PST",984,996,86,-898
SCL,"11/28/2024 4 a.m. PST",985,995,122,-863
SCL,"11/28/2024 5 a.m. PST",1010,1015,159,-851
SCL,"11/28/2024 6 a.m. PST",1072,1071,325,-747
SCL,"11/28/2024 7 a.m. PST",1141,1145,499,-642
SCL,"11/28/2024 8 a.m. PST",1210,1207,523,-687
SCL,"11/28/2024 9 a.m. PST",1264,1251,538,-726
SCL,"11/28/2024 10 a.m. PST",1311,1284,170,-1141
SCL,"11/28/2024 11 a.m. PST",1336,1290,130,-1206
SCL,"11/28/2024 12 p.m. PST",1343,1280,127,-1216
SCL,"11/28/2024 1 p.m. PST",1308,1269,132,-1176
SCL,"11/28/2024 2 p.m. PST",1259,1251,286,-973
SCL,"11/28/2024 3 p.m. PST",1231,1222,239,-992
SCL,"11/28/2024 4 p.m. PST",1218,1221,296,-922
SCL,"11/28/2024 5 p.m. PST",1236,1229,437,-799
SCL,"11/28/2024 6 p.m. PST",1239,1230,503,-736
SCL,"11/28/2024 7 p.m. PST",1205,1191,485,-720
SCL,"11/28/2024 8 p.m. PST",1180,1176,485,-695
SCL,"11/28/2024 9 p.m. PST",1176,1175,447,-729
SCL,"11/28/2024 10 p.m. PST",1169,1154,424,-745
SCL,"11/28/2024 11 p.m. PST",1130,1110,173,-957
SCL,"11/29/2024 12 a.m. PST",1089,1070,185,-904
SCL,"11/29/2024 1 a.m. PST",1043,1064,88,-955
SCL,"11/29/2024 2 a.m. PST",1010,1037,84,-926
SCL,"11/29/2024 3 a.m. PST",995,1029,86,-909
SCL,"11/29/2024 4 a.m. PST",999,1038,87,-912
SCL,"11/29/2024 5 a.m. PST",1029,1068,162,-867
SCL,"11/29/2024 6 a.m. PST",1097,1141,311,-786
SCL,"11/29/2024 7 a.m. PST",1179,1226,469,-710
SCL,"11/29/2024 8 a.m. PST",1240,1286,501,-739
SCL,"11/29/2024 9 a.m. PST",1280,1309,502,-778
SCL,"11/29/2024 10 a.m. PST",1300,1330,377,-923
SCL,"11/29/2024 11 a.m. PST",1302,1331,289,-1013
SCL,"11/29/2024 12 p.m. PST",1283,1323,290,-993
SCL,"11/29/2024 1 p.m. PST",1267,1309,288,-979
SCL,"11/29/2024 2 p.m. PST",1268,1294,284,-984
SCL,"11/29/2024 3 p.m. PST",1268,1279,297,-971
SCL,"11/29/2024 4 p.m. PST",1275,1300,507,-768
SCL,"11/29/2024 5 p.m. PST",1337,1342,540,-797
SCL,"11/29/2024 6 p.m. PST",1375,1357,562,-813
SCL,"11/29/2024 7 p.m. PST",1339,1336,587,-752
SCL,"11/29/2024 8 p.m. PST",1311,1316,584,-727
SCL,"11/29/2024 9 p.m. PST",1278,1283,604,-674
SCL,"11/29/2024 10 p.m. PST",1230,1256,411,-819
SCL,"11/29/2024 11 p.m. PST",1171,1202,195,-976
SCL,"11/30/2024 12 a.m. PST",1109,1142,82,-1027
SCL,"11/30/2024 1 a.m. PST",1063,1078,84,-979
SCL,"11/30/2024 2 a.m. PST",1031,1040,82,-949
SCL,"11/30/2024 3 a.m. PST",1007,1023,83,-924
SCL,"11/30/2024 4 a.m. PST",1004,1021,103,-901
SCL,"11/30/2024 5 a.m. PST",1023,1040,173,-850
SCL,"11/30/2024 6 a.m. PST",1064,1088,227,-837
SCL,"11/30/2024 7 a.m. PST",1124,1160,500,-624
SCL,"11/30/2024 8 a.m. PST",1193,1240,526,-667
SCL,"11/30/2024 9 a.m. PST",1250,1295,529,-721
SCL,"11/30/2024 10 a.m. PST",1261,1319,437,-824
SCL,"11/30/2024 11 a.m. PST",1253,1313,339,-914
SCL,"11/30/2024 12 p.m. PST",1231,1288,336,-895
SCL,"11/30/2024 1 p.m. PST",1209,1263,298,-911
SCL,"11/30/2024 2 p.m. PST",1179,1243,285,-894
SCL,"11/30/2024 3 p.m. PST",1187,1227,296,-891
SCL,"11/30/2024 4 p.m. PST",1210,1242,465,-745
SCL,"11/30/2024 5 p.m. PST",1266,1291,601,-665
SCL,"11/30/2024 6 p.m. PST",1294,1339,604,-690
SCL,"11/30/2024 7 p.m. PST",1297,1337,615,-682
SCL,"11/30/2024 8 p.m. PST",1263,1313,618,-645
SCL,"11/30/2024 9 p.m. PST",1244,1290,410,-834
SCL,"11/30/2024 10 p.m. PST",1212,1242,380,-832
SCL,"11/30/2024 11 p.m. PST",1156,1191,90,-1066