"BA Code","Timestamp (Hour Ending)","Demand (MWh)","Demand Forecast (MWh)","Net Generation (MWh)","Total Interchange (MWh)"
SCL,"1/1/2025 12 a.m. PST",990,1152,360,-630
SCL,"1/1/2025 1 a.m. PST",1029,1035,379,-650
SCL,"1/1/2025 2 a.m. PST",1010,1015,352,-658
SCL,"1/1/2025 3 a.m. PST",994,995,381,-613
SCL,"1/1/2025 4 a.m. PST",991,990,384,-607
SCL,"1/1/2025 5 a.m. PST",999,1012,398,-601
SCL,"1/1/2025 6 a.m. PST",1054,1076,494,-560
SCL,"1/1/2025 7 a.m. PST",1108,1168,497,-611
SCL,"1/1/2025 8 a.m. PST",1150,1230,490,-660
SCL,"1/1/2025 9 a.m. PST",1168,1246,507,-661
SCL,"1/1/2025 10 a.m. PST",1209,1253,475,-734
SCL,"1/1/2025 11 a.m. PST",1239,1250,383,-856
SCL,"1/1/2025 12 p.m. PST",1243,1238,341,-902
SCL,"1/1/2025 1 p.m. PST",1241,1232,341,-900
SCL,"1/1/2025 2 p.m. PST",1240,1236,342,-898
SCL,"1/1/2025 3 p.m. PST",1253,1228,380,-873
SCL,"1/1/2025 4 p.m. PST",1269,1253,404,-865
SCL,"1/1/2025 5 p.m. PST",1317,1322,700,-617
SCL,"1/1/2025 6 p.m. PST",1366,1363,734,-632
SCL,"1/1/2025 7 p.m. PST",1334,1354,674,-660
SCL,"1/1/2025 8 p.m. PST",1308,1323,672,-636
SCL,"1/1/2025 9 p.m. PST",1272,1289,550,-722
SCL,"1/1/2025 10 p.m. PST",1220,1226,471,-749
SCL,"1/1/2025 11 p.m. PST",1155,1155,466,-689
SCL,"1/2/2025 12 a.m. PST",1085,1087,448,-637
SCL,"1/2/2025 1 a.m. PST",1029,1035,381,-648
SCL,"1/2/2025 2 a.m. PST",999,1006,327,-672
SCL,"1/2/2025 3 a.m. PST",982,991,327,-655
SCL,"1/2/2025 4 a.m. PST",994,1001,341,-653
SCL,"1/2/2025 5 a.m. PST",1037,1049,411,-626
SCL,"1/2/2025 6 a.m. PST",1130,1155,600,-530
SCL,"1/2/2025 7 a.m. PST",1245,1303,517,-728
SCL,"1/2/2025 8 a.m. PST",1338,1423,569,-769
SCL,"1/2/2025 9 a.m. PST",1386,1456,533,-853
SCL,"1/2/2025 10 a.m. PST",1399,1451,389,-1010
SCL,"1/2/2025 11 a.m. PST",1392,1431,335,-1057
SCL,"1/2/2025 12 p.m. PST",1387,1409,364,-1023
SCL,"1/2/2025 1 p.m. PST",1386,1399,307,-1079
SCL,"1/2/2025 2 p.m. PST",1381,1379,308,-1073
SCL,"1/2/2025 3 p.m. PST",1378,1364,313,-1065
SCL,"1/2/2025 4 p.m. PST",1387,1356,504,-883
SCL,"1/2/2025 5 p.m. PST",1423,1412,650,-773
SCL,"1/2/2025 6 p.m. PST",1437,1468,655,-782
SCL,"1/2/2025 7 p.m. PST",1398,1447,656,-742
SCL,"1/2/2025 8 p.m. PST",1353,1406,618,-735
SCL,"1/2/2025 9 p.m. PST",1315,1361,562,-753
SCL,"1/2/2025 10 p.m. PST",1262,1295,395,-867
SCL,"1/2/2025 11 p.m. PST",1183,1212,396,-787
SCL,"1/3/2025 12 a.m. PST",1116,1128,421,-695
SCL,"1/3/2025 1 a.m. PST",1058,1058,285,-773
SCL,"1/3/2025 2 a.m. PST",1021,1028,298,-723
SCL,"1/3/2025 3 a.m. PST",1002,1011,238,-764
SCL,"1/3/2025 4 a.m. PST",996,1016,287,-709
SCL,"1/3/2025 5 a.m. PST",1033,1056,358,-675
SCL,"1/3/2025 6 a.m. PST",1118,1149,377,-741
SCL,"1/3/2025 7 a.m. PST",1229,1285,488,-741
SCL,"1/3/2025 8 a.m. PST",1322,1396,546,-776
SCL,"1/3/2025 9 a.m. PST",1380,1434,538,-842
SCL,"1/3/2025 10 a.m. PST",1416,1433,380,-1036
SCL,"1/3/2025 11 a.m. PST",1453,1422,363,-1090
SCL,"1/3/2025 12 p.m. PST",1447,1407,368,-1079
SCL,"1/3/2025 1 p.m. PST",1448,1392,365,-1083
SCL,"1/3/2025 2 p.m. PST",1432,1375,319,-1113
SCL,"1/3/2025 3 p.m. PST",1430,1358,315,-1115
SCL,"1/3/2025 4 p.m. PST",1431,1349,440,-991
SCL,"1/3/2025 5 p.m. PST",1452,1389,536,-916
SCL,"1/3/2025 6 p.m. PST",1462,1443,529,-933
SCL,"1/3/2025 7 p.m. PST",1406,1415,553,-853
SCL,"1/3/2025 8 p.m. PST",1367,1366,540,-827
SCL,"1/3/2025 9 p.m. PST",1305,1319,536,-769
SCL,"1/3/2025 10 p.m. PST",1272,1265,475,-797
SCL,"1/3/2025 11 p.m. PST",1200,1201,306,-894
SCL,"1/4/2025 12 a.m. PST",1147,1128,274,-873
SCL,"1/4/2025 1 a.m. PST",1100,1062,316,-784
SCL,"1/4/2025 2 a.m. PST",1061,1021,323,-738
SCL,"1/4/2025 3 a.m. PST",1024,1000,319,-705
SCL,"1/4/2025 4 a.m. PST",1019,995,319,-700
SCL,"1/4/2025 5 a.m. PST",1033,1006,313,-720
SCL,"1/4/2025 6 a.m. PST",1069,1044,320,-749
SCL,"1/4/2025 7 a.m. PST",1124,1106,457,-667
SCL,"1/4/2025 8 a.m. PST",1178,1178,451,-727
SCL,"1/4/2025 9 a.m. PST",1227,1233,388,-839
SCL,"1/4/2025 10 a.m. PST",1226,1281,363,-863
SCL,"1/4/2025 11 a.m. PST",1272,1298,314,-958
SCL,"1/4/2025 12 p.m. PST",1304,1299,298,-1006
SCL,"1/4/2025 1 p.m. PST",1308,1285,296,-1012
SCL,"1/4/2025 2 p.m. PST",1313,1267,302,-1011
SCL,"1/4/2025 3 p.m. PST",1316,1252,306,-1010
SCL,"1/4/2025 4 p.m. PST",1325,1264,370,-955
SCL,"1/4/2025 5 p.m. PST",1367,1306,555,-812
SCL,"1/4/2025 6 p.m. PST",1388,1355,535,-853
SCL,"1/4/2025 7 p.m. PST",1362,1350,525,-837
SCL,"1/4/2025 8 p.m. PST",1334,1311,528,-806
SCL,"1/4/2025 9 p.m. PST",1300,1274,426,-874
SCL,"1/4/2025 10 p.m. PST",1252,1226,372,-880
SCL,"1/4/2025 11 p.m. PST",1188,1163,408,-780
SCL,"1/5/2025 12 a.m. PST",1120,1091,354,-766
SCL,"1/5/2025 1 a.m. PST",1069,1035,224,-845
SCL,"1/5/2025 2 a.m. PST",1021,997,206,-815
SCL,"1/5/2025 3 a.m. PST",982,973,149,-833
SCL,"1/5/2025 4 a.m. PST",978,963,125,-853
SCL,"1/5/2025 5 a.m. PST",975,962,118,-857
SCL,"1/5/2025 6 a.m. PST",1008,984,157,-851
SCL,"1/5/2025 7 a.m. PST",1046,1033,282,-764
SCL,"1/5/2025 8 a.m. PST",1085,1088,273,-812
SCL,"1/5/2025 9 a.m. PST",1146,1133,272,-874
SCL,"1/5/2025 10 a.m. PST",1182,1188,257,-925
SCL,"1/5/2025 11 a.m. PST",1210,1220,255,-955
SCL,"1/5/2025 12 p.m. PST",1235,1236,256,-979
SCL,"1/5/2025 1 p.m. PST",1241,1237,225,-1016
SCL,"1/5/2025 2 p.m. PST",1249,1233,221,-1028
SCL,"1/5/2025 3 p.m. PST",1260,1237,314,-946
SCL,"1/5/2025 4 p.m. PST",1276,1249,361,-915
SCL,"1/5/2025 5 p.m. PST",1316,1291,574,-742
SCL,"1/5/2025 6 p.m. PST",1363,1350,641,-722
SCL,"1/5/2025 7 p.m. PST",1358,1352,619,-739
SCL,"1/5/2025 8 p.m. PST",1328,1332,593,-735
SCL,"1/5/2025 9 p.m. PST",1298,1290,515,-783
SCL,"1/5/2025 10 p.m. PST",1239,1232,384,-855
SCL,"1/5/2025 11 p.m. PST",1150,1154,236,-914
SCL,"1/6/2025 12 a.m. PST",1070,1076,183,-887
SCL,"1/6/2025 1 a.m. PST",1016,979,179,-837
SCL,"1/6/2025 2 a.m. PST",983,947,198,-785
SCL,"1/6/2025 3 a.m. PST",955,935,178,-777
SCL,"1/6/2025 4 a.m. PST",983,949,194,-789
SCL,"1/6/2025 5 a.m. PST",1052,998,218,-834
SCL,"1/6/2025 6 a.m. PST",1143,1100,323,-820
SCL,"1/6/2025 7 a.m. PST",1298,1244,478,-820
SCL,"1/6/2025 8 a.m. PST",1406,1368,538,-868
SCL,"1/6/2025 9 a.m. PST",1393,1406,491,-902
SCL,"1/6/2025 10 a.m. PST",1394,1405,348,-1046
SCL,"1/6/2025 11 a.m. PST",1432,1398,349,-1083
SCL,"1/6/2025 12 p.m. PST",1428,1393,350,-1078
SCL,"1/6/2025 1 p.m. PST",1432,1371,356,-1076
SCL,"1/6/2025 2 p.m. PST",1428,1347,355,-1073
SCL,"1/6/2025 3 p.m. PST",1414,1333,400,-1014
SCL,"1/6/2025 4 p.m. PST",1421,1330,567,-854
SCL,"1/6/2025 5 p.m. PST",1469,1369,667,-802
SCL,"1/6/2025 6 p.m. PST",1515,1437,727,-788
SCL,"1/6/2025 7 p.m. PST",1489,1420,674,-815
SCL,"1/6/2025 8 p.m. PST",1439,1378,589,-850
SCL,"1/6/2025 9 p.m. PST",1401,1337,530,-871
SCL,"1/6/2025 10 p.m. PST",1321,1278,394,-927
SCL,"1/6/2025 11 p.m. PST",1226,1184,364,-862
SCL,"1/7/2025 12 a.m. PST",1040,1101,168,-872
SCL,"1/7/2025 1 a.m. PST",1058,1043,162,-896
SCL,"1/7/2025 2 a.m. PST",1030,1011,154,-876
SCL,"1/7/2025 3 a.m. PST",1026,999,152,-874
SCL,"1/7/2025 4 a.m. PST",1027,1010,125,-902
SCL,"1/7/2025 5 a.m. PST",1081,1057,155,-926
SCL,"1/7/2025 6 a.m. PST",1195,1165,365,-830
SCL,"1/7/2025 7 a.m. PST",1301,1316,361,-940
SCL,"1/7/2025 8 a.m. PST",1411,1447,632,-779
SCL,"1/7/2025 9 a.m. PST",1424,1462,566,-858
SCL,"1/7/2025 10 a.m. PST",1412,1445,144,-1268
SCL,"1/7/2025 11 a.m. PST",1384,1414,141,-1243
SCL,"1/7/2025 12 p.m. PST",1394,1390,145,-1249
SCL,"1/7/2025 1 p.m. PST",1385,1368,176,-1209
SCL,"1/7/2025 2 p.m. PST",1374,1339,240,-1134
SCL,"1/7/2025 3 p.m. PST",1330,1321,246,-1084
SCL,"1/7/2025 4 p.m. PST",1354,1312,311,-1043
SCL,"1/7/2025 5 p.m. PST",1409,1368,537,-872
SCL,"1/7/2025 6 p.m. PST",1447,1430,535,-912
SCL,"1/7/2025 7 p.m. PST",1422,1414,493,-929
SCL,"1/7/2025 8 p.m. PST",1383,1374,475,-908
SCL,"1/7/2025 9 p.m. PST",1336,1329,384,-952
SCL,"1/7/2025 10 p.m. PST",1264,1257,317,-947
SCL,"1/7/2025 11 p.m. PST",1165,1166,320,-845
SCL,"1/8/2025 12 a.m. PST",1073,1085,140,-933
SCL,"1/8/2025 1 a.m. PST",1014,1023,142,-872
SCL,"1/8/2025 2 a.m. PST",973,984,143,-830
SCL,"1/8/2025 3 a.m. PST",956,967,138,-818
SCL,"1/8/2025 4 a.m. PST",958,975,107,-851
SCL,"1/8/2025 5 a.m. PST",1004,1024,161,-843
SCL,"1/8/2025 6 a.m. PST",1102,1130,332,-770
SCL,"1/8/2025 7 a.m. PST",1251,1276,465,-786
SCL,"1/8/2025 8 a.m. PST",1364,1405,664,-700
SCL,"1/8/2025 9 a.m. PST",1367,1438,571,-796
SCL,"1/8/2025 10 a.m. PST",1362,1432,293,-1069
SCL,"1/8/2025 11 a.m. PST",1334,1414,235,-1099
SCL,"1/8/2025 12 p.m. PST",1288,1390,243,-1045
SCL,"1/8/2025 1 p.m. PST",1256,1371,238,-1018
SCL,"1/8/2025 2 p.m. PST",1246,1352,234,-1012
SCL,"1/8/2025 3 p.m. PST",1241,1338,241,-1000
SCL,"1/8/2025 4 p.m. PST",1241,1347,308,-933
SCL,"1/8/2025 5 p.m. PST",1293,1400,541,-752
SCL,"1/8/2025 6 p.m. PST",1371,1459,569,-802
SCL,"1/8/2025 7 p.m. PST",1361,1451,501,-860
SCL,"1/8/2025 8 p.m. PST",1333,1411,490,-843
SCL,"1/8/2025 9 p.m. PST",1283,1370,472,-811
SCL,"1/8/2025 10 p.m. PST",1227,1303,377,-850
SCL,"1/8/2025 11 p.m. PST",1136,1217,382,-754
SCL,"1/9/2025 12 a.m. PST",1050,1133,205,-845
SCL,"1/9/2025 1 a.m. PST",989,1004,123,-866
SCL,"1/9/2025 2 a.m. PST",950,965,151,-799
SCL,"1/9/2025 3 a.m. PST",930,950,145,-785
SCL,"1/9/2025 4 a.m. PST",938,960,148,-790
SCL,"1/9/2025 5 a.m. PST",975,1010,167,-808
SCL,"1/9/2025 6 a.m. PST",1078,1121,342,-736
SCL,"1/9/2025 7 a.m. PST",1233,1278,542,-691
SCL,"1/9/2025 8 a.m. PST",1344,1409,598,-746
SCL,"1/9/2025 9 a.m. PST",1370,1431,466,-904
SCL,"1/9/2025 10 a.m. PST",1346,1421,239,-1107
SCL,"1/9/2025 11 a.m. PST",1312,1402,234,-1078
SCL,"1/9/2025 12 p.m. PST",1283,1382,235,-1048
SCL,"1/9/2025 1 p.m. PST",1249,1364,204,-1045
SCL,"1/9/2025 2 p.m. PST",1230,1344,201,-1029
SCL,"1/9/2025 3 p.m. PST",1203,1327,205,-998
SCL,"1/9/2025 4 p.m. PST",1208,1317,305,-903
SCL,"1/9/2025 5 p.m. PST",1272,1371,546,-726
SCL,"1/9/2025 6 p.m. PST",1344,1434,646,-698
SCL,"1/9/2025 7 p.m. PST",1340,1420,575,-765
SCL,"1/9/2025 8 p.m. PST",1314,1386,575,-739
SCL,"1/9/2025 9 p.m. PST",1280,1340,535,-745
SCL,"1/9/2025 10 p.m. PST",1208,1274,380,-828
SCL,"1/9/2025 11 p.m. PST",1132,1187,339,-793
SCL,"1/10/2025 12 a.m. PST",1046,1109,220,-826
SCL,"1/10/2025 1 a.m. PST",988,998,177,-811
SCL,"1/10/2025 2 a.m. PST",949,963,168,-781
SCL,"1/10/2025 3 a.m. PST",926,947,159,-767
SCL,"1/10/2025 4 a.m. PST",927,954,163,-764
SCL,"1/10/2025 5 a.m. PST",965,996,180,-785
SCL,"1/10/2025 6 a.m. PST",1055,1090,377,-678
SCL,"1/10/2025 7 a.m. PST",1207,1226,410,-797
SCL,"1/10/2025 8 a.m. PST",1319,1345,584,-735
SCL,"1/10/2025 9 a.m. PST",1356,1378,525,-831
SCL,"1/10/2025 10 a.m. PST",1369,1371,423,-946
SCL,"1/10/2025 11 a.m. PST",1380,1356,257,-1123
SCL,"1/10/2025 12 p.m. PST",1397,1338,219,-1178
SCL,"1/10/2025 1 p.m. PST",1382,1324,218,-1164
SCL,"1/10/2025 2 p.m. PST",1345,1300,226,-1119
SCL,"1/10/2025 3 p.m. PST",1302,1296,214,-1088
SCL,"1/10/2025 4 p.m. PST",1318,1301,294,-1024
SCL,"1/10/2025 5 p.m. PST",1344,1333,415,-929
SCL,"1/10/2025 6 p.m. PST",1403,1384,410,-993
SCL,"1/10/2025 7 p.m. PST",1376,1357,372,-1004
SCL,"1/10/2025 8 p.m. PST",1332,1309,335,-997
SCL,"1/10/2025 9 p.m. PST",1302,1264,342,-960
SCL,"1/10/2025 10 p.m. PST",1256,1218,375,-881
SCL,"1/10/2025 11 p.m. PST",1168,1151,253,-915
SCL,"1/11/2025 12 a.m. PST",1023,1088,218,-805
SCL,"1/11/2025 1 a.m. PST",1056,1038,182,-874
SCL,"1/11/2025 2 a.m. PST",1020,995,175,-845
SCL,"1/11/2025 3 a.m. PST",1009,976,130,-879
SCL,"1/11/2025 4 a.m. PST",1004,973,127,-877
SCL,"1/11/2025 5 a.m. PST",1016,986,163,-853
SCL,"1/11/2025 6 a.m. PST",1054,1024,167,-887
SCL,"1/11/2025 7 a.m. PST",1123,1088,323,-800
SCL,"1/11/2025 8 a.m. PST",1189,1156,337,-852
SCL,"1/11/2025 9 a.m. PST",1237,1201,317,-920
SCL,"1/11/2025 10 a.m. PST",1293,1240,283,-1010
SCL,"1/11/2025 11 a.m. PST",1304,1253,253,-1051
SCL,"1/11/2025 12 p.m. PST",1270,1255,268,-1002
SCL,"1/11/2025 1 p.m. PST",1270,1243,240,-1030
SCL,"1/11/2025 2 p.m. PST",1261,1221,234,-1027
SCL,"1/11/2025 3 p.m. PST",1240,1221,257,-983
SCL,"1/11/2025 4 p.m. PST",1237,1229,322,-915
SCL,"1/11/2025 5 p.m. PST",1283,1265,400,-883
SCL,"1/11/2025 6 p.m. PST",1320,1327,336,-984
SCL,"1/11/2025 7 p.m. PST",1324,1324,505,-819
SCL,"1/11/2025 8 p.m. PST",1326,1291,614,-712
SCL,"1/11/2025 9 p.m. PST",1312,1261,532,-780
SCL,"1/11/2025 10 p.m. PST",1281,1218,447,-834
SCL,"1/11/2025 11 p.m. PST",1219,1154,260,-959
SCL,"1/12/2025 12 a.m. PST",1140,1085,203,-937
SCL,"1/12/2025 1 a.m. PST",1103,1079,224,-879
SCL,"1/12/2025 2 a.m. PST",1037,1042,165,-872
SCL,"1/12/2025 3 a.m. PST",1012,1022,134,-878
SCL,"1/12/2025 4 a.m. PST",1009,1015,152,-857
SCL,"1/12/2025 5 a.m. PST",1018,1019,156,-862
SCL,"1/12/2025 6 a.m. PST",1056,1043,306,-750
SCL,"1/12/2025 7 a.m. PST",1139,1093,352,-787
SCL,"1/12/2025 8 a.m. PST",1197,1153,308,-889
SCL,"1/12/2025 9 a.m. PST",1242,1191,406,-836
SCL,"1/12/2025 10 a.m. PST",1288,1233,404,-884
SCL,"1/12/2025 11 a.m. PST",1334,1258,241,-1093
SCL,"1/12/2025 12 p.m. PST",1360,1267,246,-1114
SCL,"1/12/2025 1 p.m. PST",1368,1269,248,-1120
SCL,"1/12/2025 2 p.m. PST",1362,1269,242,-1120
SCL,"1/12/2025 3 p.m. PST",1347,1266,232,-1115
SCL,"1/12/2025 4 p.m. PST",1349,1277,419,-930
SCL,"1/12/2025 5 p.m. PST",1401,1317,652,-749
SCL,"1/12/2025 6 p.m. PST",1466,1393,706,-760
SCL,"1/12/2025 7 p.m. PST",1481,1398,652,-829
SCL,"1/12/2025 8 p.m. PST",1460,1384,562,-898
SCL,"1/12/2025 9 p.m. PST",1431,1343,565,-866
SCL,"1/12/2025 10 p.m. PST",1379,1290,585,-794
SCL,"1/12/2025 11 p.m. PST",1287,1209,492,-795
SCL,"1/13/2025 12 a.m. PST",1199,1133,391,-808
SCL,"1/13/2025 1 a.m. PST",1141,1102,192,-949
SCL,"1/13/2025 2 a.m. PST",1109,1073,171,-938
SCL,"1/13/2025 3 a.m. PST",1103,1065,169,-934
SCL,"1/13/2025 4 a.m. PST",1123,1082,175,-948
SCL,"1/13/2025 5 a.m. PST",1162,1133,191,-971
SCL,"1/13/2025 6 a.m. PST",1275,1241,364,-911
SCL,"1/13/2025 7 a.m. PST",1424,1389,506,-918
SCL,"1/13/2025 8 a.m. PST",1545,1511,541,-1004
SCL,"1/13/2025 9 a.m. PST",1563,1534,524,-1039
SCL,"1/13/2025 10 a.m. PST",1567,1519,493,-1074
SCL,"1/13/2025 11 a.m. PST",1551,1500,388,-1163
SCL,"1/13/2025 12 p.m. PST",1533,1480,371,-1162
SCL,"1/13/2025 1 p.m. PST",1507,1449,368,-1139
SCL,"1/13/2025 2 p.m. PST",1494,1416,310,-1184
SCL,"1/13/2025 3 p.m. PST",1476,1410,299,-1177
SCL,"1/13/2025 4 p.m. PST",1487,1409,320,-1167
SCL,"1/13/2025 5 p.m. PST",1521,1442,570,-951
SCL,"1/13/2025 6 p.m. PST",1579,1504,541,-1038
SCL,"1/13/2025 7 p.m. PST",1557,1489,534,-1023
SCL,"1/13/2025 8 p.m. PST",1514,1441,588,-926
SCL,"1/13/2025 9 p.m. PST",1465,1394,458,-1007
SCL,"1/13/2025 10 p.m. PST",1372,1334,385,-987
SCL,"1/13/2025 11 p.m. PST",1261,1237,428,-833
SCL,"1/14/2025 12 a.m. PST",1175,1157,231,-944
SCL,"1/14/2025 1 a.m. PST",1113,1119,180,-933
SCL,"1/14/2025 2 a.m. PST",1080,1092,179,-901
SCL,"1/14/2025 3 a.m. PST",1088,1080,176,-912
SCL,"1/14/2025 4 a.m. PST",1119,1092,181,-938
SCL,"1/14/2025 5 a.m. PST",1161,1143,185,-976
SCL,"1/14/2025 6 a.m. PST",1268,1254,491,-777
SCL,"1/14/2025 7 a.m. PST",1424,1406,683,-741
SCL,"1/14/2025 8 a.m. PST",1539,1526,709,-830
SCL,"1/14/2025 9 a.m. PST",1563,1555,487,-1076
SCL,"1/14/2025 10 a.m. PST",1552,1540,469,-1083
SCL,"1/14/2025 11 a.m. PST",1537,1512,298,-1239
SCL,"1/14/2025 12 p.m. PST",1534,1486,306,-1228
SCL,"1/14/2025 1 p.m. PST",1464,1463,291,-1173
SCL,"1/14/2025 2 p.m. PST",1441,1440,285,-1156
SCL,"1/14/2025 3 p.m. PST",1434,1416,303,-1131
SCL,"1/14/2025 4 p.m. PST",1436,1415,335,-1101
SCL,"1/14/2025 5 p.m. PST",1492,1463,554,-938
SCL,"1/14/2025 6 p.m. PST",1562,1525,563,-999
SCL,"1/14/2025 7 p.m. PST",1538,1521,553,-985
SCL,"1/14/2025 8 p.m. PST",1515,1479,527,-988
SCL,"1/14/2025 9 p.m. PST",1470,1438,510,-960
SCL,"1/14/2025 10 p.m. PST",1400,1369,357,-1043
SCL,"1/14/2025 11 p.m. PST",1299,1280,359,-940
SCL,"1/15/2025 12 a.m. PST",1193,1196,151,-1042
SCL,"1/15/2025 1 a.m. PST",1095,1120,183,-912
SCL,"1/15/2025 2 a.m. PST",1053,1070,184,-869
SCL,"1/15/2025 3 a.m. PST",1040,1056,188,-852
SCL,"1/15/2025 4 a.m. PST",1046,1067,186,-860
SCL,"1/15/2025 5 a.m. PST",1093,1119,192,-901
SCL,"1/15/2025 6 a.m. PST",1196,1235,532,-664
SCL,"1/15/2025 7 a.m. PST",1358,1390,693,-665
SCL,"1/15/2025 8 a.m. PST",1466,1517,684,-782
SCL,"1/15/2025 9 a.m. PST",1486,1545,565,-921
SCL,"1/15/2025 10 a.m. PST",1473,1528,534,-939
SCL,"1/15/2025 11 a.m. PST",1472,1498,284,-1188
SCL,"1/15/2025 12 p.m. PST",1461,1471,303,-1158
SCL,"1/15/2025 1 p.m. PST",1446,1441,302,-1144
SCL,"1/15/2025 2 p.m. PST",1446,1419,305,-1141
SCL,"1/15/2025 3 p.m. PST",1431,1395,298,-1133
SCL,"1/15/2025 4 p.m. PST",1437,1388,412,-1025
SCL,"1/15/2025 5 p.m. PST",1479,1444,675,-804
SCL,"1/15/2025 6 p.m. PST",1524,1514,724,-800
SCL,"1/15/2025 7 p.m. PST",1489,1503,705,-784
SCL,"1/15/2025 8 p.m. PST",1458,1470,575,-883
SCL,"1/15/2025 9 p.m. PST",1412,1430,586,-826
SCL,"1/15/2025 10 p.m. PST",1338,1361,461,-877
SCL,"1/15/2025 11 p.m. PST",592,1261,279,-313
SCL,"1/16/2025 12 a.m. PST",1146,1178,274,-872
SCL,"1/16/2025 1 a.m. PST",1089,1101,189,-900
SCL,"1/16/2025 2 a.m. PST",1051,1058,186,-865
SCL,"1/16/2025 3 a.m. PST",1035,1043,184,-851
SCL,"1/16/2025 4 a.m. PST",1043,1052,228,-815
SCL,"1/16/2025 5 a.m. PST",1091,1102,249,-842
SCL,"1/16/2025 6 a.m. PST",1192,1213,521,-671
SCL,"1/16/2025 7 a.m. PST",1351,1362,583,-768
SCL,"1/16/2025 8 a.m. PST",1470,1481,661,-809
SCL,"1/16/2025 9 a.m. PST",1500,1514,623,-877
SCL,"1/16/2025 10 a.m. PST",1504,1507,291,-1213
SCL,"1/16/2025 11 a.m. PST",1507,1488,178,-1329
SCL,"1/16/2025 12 p.m. PST",1491,1465,167,-1324
SCL,"1/16/2025 1 p.m. PST",1479,1453,323,-1156
SCL,"1/16/2025 2 p.m. PST",1443,1440,153,-1290
SCL,"1/16/2025 3 p.m. PST",1420,1418,154,-1266
SCL,"1/16/2025 4 p.m. PST",1393,1419,184,-1209
SCL,"1/16/2025 5 p.m. PST",1433,1468,187,-1246
SCL,"1/16/2025 6 p.m. PST",1486,1524,354,-1132
SCL,"1/16/2025 7 p.m. PST",1454,1510,354,-1100
SCL,"1/16/2025 8 p.m. PST",1423,1475,342,-1081
SCL,"1/16/2025 9 p.m. PST",1380,1434,362,-1018
SCL,"1/16/2025 10 p.m. PST",1318,1366,359,-959
SCL,"1/16/2025 11 p.m. PST",1222,1275,385,-837
SCL,"1/17/2025 12 a.m. PST",1058,1194,213,-845
SCL,"1/17/2025 1 a.m. PST",1075,1089,180,-895
SCL,"1/17/2025 2 a.m. PST",1040,1052,180,-860
SCL,"1/17/2025 3 a.m. PST",1021,1037,180,-841
SCL,"1/17/2025 4 a.m. PST",1043,1047,176,-867
SCL,"1/17/2025 5 a.m. PST",1103,1098,189,-914
SCL,"1/17/2025 6 a.m. PST",1200,1206,414,-786
SCL,"1/17/2025 7 a.m. PST",1347,1357,513,-834
SCL,"1/17/2025 8 a.m. PST",1463,1480,658,-805
SCL,"1/17/2025 9 a.m. PST",1498,1518,640,-858
SCL,"1/17/2025 10 a.m. PST",1523,1512,444,-1079
SCL,"1/17/2025 11 a.m. PST",1514,1497,322,-1192
SCL,"1/17/2025 12 p.m. PST",1494,1483,180,-1314
SCL,"1/17/2025 1 p.m. PST",1470,1467,177,-1293
SCL,"1/17/2025 2 p.m. PST",1438,1444,183,-1255
SCL,"1/17/2025 3 p.m. PST",1426,1427,179,-1247
SCL,"1/17/2025 4 p.m. PST",1431,1434,199,-1232
SCL,"1/17/2025 5 p.m. PST",1473,1476,516,-957
SCL,"1/17/2025 6 p.m. PST",1543,1533,691,-852
SCL,"1/17/2025 7 p.m. PST",1510,1501,591,-919
SCL,"1/17/2025 8 p.m. PST",1480,1455,537,-943
SCL,"1/17/2025 9 p.m. PST",1454,1412,470,-984
SCL,"1/17/2025 10 p.m. PST",1398,1353,351,-1047
SCL,"1/17/2025 11 p.m. PST",1339,1281,360,-979
SCL,"1/18/2025 12 a.m. PST",1275,1218,193,-1082
SCL,"1/18/2025 1 a.m. PST",1226,1186,177,-1049
SCL,"1/18/2025 2 a.m. PST",1204,1152,181,-1023
SCL,"1/18/2025 3 a.m. PST",1158,1135,177,-981
SCL,"1/18/2025 4 a.m. PST",1186,1129,195,-991
SCL,"1/18/2025 5 a.m. PST",1202,1137,206,-996
SCL,"1/18/2025 6 a.m. PST",1252,1173,457,-795
SCL,"1/18/2025 7 a.m. PST",1318,1236,413,-905
SCL,"1/18/2025 8 a.m. PST",1363,1304,492,-871
SCL,"1/18/2025 9 a.m. PST",1422,1353,438,-984
SCL,"1/18/2025 10 a.m. PST",1503,1380,348,-1155
SCL,"1/18/2025 11 a.m. PST",1470,1382,342,-1128
SCL,"1/18/2025 12 p.m. PST",1441,1369,184,-1257
SCL,"1/18/2025 1 p.m. PST",1391,1345,184,-1207
SCL,"1/18/2025 2 p.m. PST",1342,1325,181,-1161
SCL,"1/18/2025 3 p.m. PST",1321,1303,181,-1140
SCL,"1/18/2025 4 p.m. PST",1336,1319,164,-1172
SCL,"1/18/2025 5 p.m. PST",1389,1368,522,-867
SCL,"1/18/2025 6 p.m. PST",1473,1433,600,-873
SCL,"1/18/2025 7 p.m. PST",1482,1432,614,-868
SCL,"1/18/2025 8 p.m. PST",1460,1407,644,-816
SCL,"1/18/2025 9 p.m. PST",1436,1377,651,-785
SCL,"1/18/2025 10 p.m. PST",1394,1334,575,-819
SCL,"1/18/2025 11 p.m. PST",1328,1267,580,-748
SCL,"1/19/2025 12 a.m. PST",1268,1201,403,-865
SCL,"1/19/2025 1 a.m. PST",1227,1172,191,-1036
SCL,"1/19/2025 2 a.m. PST",1197,1145,176,-1021
SCL,"1/19/2025 3 a.m. PST",1180,1128,195,-985
SCL,"1/19/2025 4 a.m. PST",1186,1126,194,-992
SCL,"1/19/2025 5 a.m. PST",1204,1138,203,-1001
SCL,"1/19/2025 6 a.m. PST",1244,1174,500,-744
SCL,"1/19/2025 7 a.m. PST",1308,1232,638,-670
SCL,"1/19/2025 8 a.m. PST",1379,1297,613,-766
SCL,"1/19/2025 9 a.m. PST",1441,1339,588,-853
SCL,"1/19/2025 10 a.m. PST",1457,1378,355,-1102
SCL,"1/19/2025 11 a.m. PST",1441,1395,182,-1259
SCL,"1/19/2025 12 p.m. PST",1406,1397,203,-1203
SCL,"1/19/2025 1 p.m. PST",1380,1388,199,-1181
SCL,"1/19/2025 2 p.m. PST",1358,1379,194,-1164
SCL,"1/19/2025 3 p.m. PST",1331,1359,201,-1130
SCL,"1/19/2025 4 p.m. PST",1346,1375,321,-1025
SCL,"1/19/2025 5 p.m. PST",1397,1427,643,-754
SCL,"1/19/2025 6 p.m. PST",1489,1506,606,-883
SCL,"1/19/2025 7 p.m. PST",1500,1513,598,-902
SCL,"1/19/2025 8 p.m. PST",1504,1502,601,-903
SCL,"1/19/2025 9 p.m. PST",1478,1466,601,-877
SCL,"1/19/2025 10 p.m. PST",1432,1403,596,-836
SCL,"1/19/2025 11 p.m. PST",1365,1319,648,-717
SCL,"1/20/2025 12 a.m. PST",1298,1240,493,-805
SCL,"1/20/2025 1 a.m. PST",1256,1191,238,-1018
SCL,"1/20/2025 2 a.m. PST",1228,1170,239,-989
SCL,"1/20/2025 3 a.m. PST",1224,1157,238,-986
SCL,"1/20/2025 4 a.m. PST",1235,1167,242,-993
SCL,"1/20/2025 5 a.m. PST",1275,1206,251,-1024
SCL,"1/20/2025 6 a.m. PST",1370,1290,592,-778
SCL,"1/20/2025 7 a.m. PST",1489,1393,700,-789
SCL,"1/20/2025 8 a.m. PST",1558,1466,708,-850
SCL,"1/20/2025 9 a.m. PST",1601,1492,592,-1009
SCL,"1/20/2025 10 a.m. PST",1605,1508,480,-1125
SCL,"1/20/2025 11 a.m. PST",1577,1501,482,-1095
SCL,"1/20/2025 12 p.m. PST",1552,1480,471,-1081
SCL,"1/20/2025 1 p.m. PST",1519,1454,459,-1060
SCL,"1/20/2025 2 p.m. PST",1482,1421,444,-1038
SCL,"1/20/2025 3 p.m. PST",1460,1402,460,-1000
SCL,"1/20/2025 4 p.m. PST",1463,1419,470,-993
SCL,"1/20/2025 5 p.m. PST",1530,1477,567,-963
SCL,"1/20/2025 6 p.m. PST",1592,1561,704,-888
SCL,"1/20/2025 7 p.m. PST",1590,1551,662,-928
SCL,"1/20/2025 8 p.m. PST",1566,1519,650,-916
SCL,"1/20/2025 9 p.m. PST",1517,1483,579,-938
SCL,"1/20/2025 10 p.m. PST",1419,1408,521,-898
SCL,"1/20/2025 11 p.m. PST",1365,1299,524,-841
SCL,"1/21/2025 12 a.m. PST",1178,1217,375,-803
SCL,"1/21/2025 1 a.m. PST",1233,1181,430,-803
SCL,"1/21/2025 2 a.m. PST",1208,1144,289,-919
SCL,"1/21/2025 3 a.m. PST",1205,1133,294,-911
SCL,"1/21/2025 4 a.m. PST",1224,1145,304,-920
SCL,"1/21/2025 5 a.m. PST",1285,1194,406,-879
SCL,"1/21/2025 6 a.m. PST",1386,1307,679,-707
SCL,"1/21/2025 7 a.m. PST",1552,1464,766,-786
SCL,"1/21/2025 8 a.m. PST",1680,1590,762,-918
SCL,"1/21/2025 9 a.m. PST",1699,1613,704,-995
SCL,"1/21/2025 10 a.m. PST",1654,1601,629,-1025
SCL,"1/21/2025 11 a.m. PST",1594,1574,641,-953
SCL,"1/21/2025 12 p.m. PST",1540,1549,590,-950
SCL,"1/21/2025 1 p.m. PST",1494,1528,551,-943
SCL,"1/21/2025 2 p.m. PST",1451,1506,545,-906
SCL,"1/21/2025 3 p.m. PST",1431,1473,557,-874
SCL,"1/21/2025 4 p.m. PST",1434,1485,525,-909
SCL,"1/21/2025 5 p.m. PST",1488,1534,667,-821
SCL,"1/21/2025 6 p.m. PST",1541,1601,689,-852
SCL,"1/21/2025 7 p.m. PST",1540,1589,789,-751
SCL,"1/21/2025 8 p.m. PST",1515,1553,756,-759
SCL,"1/21/2025 9 p.m. PST",1488,1509,739,-749
SCL,"1/21/2025 10 p.m. PST",1427,1442,661,-766
SCL,"1/21/2025 11 p.m. PST",1332,1337,478,-854
SCL,"1/22/2025 12 a.m. PST",1247,1249,457,-790
SCL,"1/22/2025 1 a.m. PST",1196,1196,400,-796
SCL,"1/22/2025 2 a.m. PST",1172,1162,409,-763
SCL,"1/22/2025 3 a.m. PST",1166,1151,405,-761
SCL,"1/22/2025 4 a.m. PST",1185,1160,495,-690
SCL,"1/22/2025 5 a.m. PST",1234,1202,523,-711
SCL,"1/22/2025 6 a.m. PST",1347,1305,782,-565
SCL,"1/22/2025 7 a.m. PST",1515,1453,825,-690
SCL,"1/22/2025 8 a.m. PST",1644,1570,875,-769
SCL,"1/22/2025 9 a.m. PST",1639,1592,741,-898
SCL,"1/22/2025 10 a.m. PST",1606,1575,694,-912
SCL,"1/22/2025 11 a.m. PST",1534,1546,654,-880
SCL,"1/22/2025 12 p.m. PST",1479,1518,653,-826
SCL,"1/22/2025 1 p.m. PST",1444,1494,508,-936
SCL,"1/22/2025 2 p.m. PST",1411,1473,483,-928
SCL,"1/22/2025 3 p.m. PST",1393,1442,484,-909
SCL,"1/22/2025 4 p.m. PST",1397,1458,686,-711
SCL,"1/22/2025 5 p.m. PST",1454,1505,793,-661
SCL,"1/22/2025 6 p.m. PST",1542,1573,808,-734
SCL,"1/22/2025 7 p.m. PST",1537,1560,795,-742
SCL,"1/22/2025 8 p.m. PST",1519,1525,795,-724
SCL,"1/22/2025 9 p.m. PST",1483,1483,782,-701
SCL,"1/22/2025 10 p.m. PST",1420,1412,786,-634
SCL,"1/22/2025 11 p.m. PST",1322,1316,737,-585
SCL,"1/23/2025 12 a.m. PST",1230,1230,695,-535
SCL,"1/23/2025 1 a.m. PST",1178,1175,657,-521
SCL,"1/23/2025 2 a.m. PST",1147,1141,566,-581
SCL,"1/23/2025 3 a.m. PST",1138,1129,590,-548
SCL,"1/23/2025 4 a.m. PST",1158,1139,605,-553
SCL,"1/23/2025 5 a.m. PST",1215,1187,621,-594
SCL,"1/23/2025 6 a.m. PST",1325,1298,838,-487
SCL,"1/23/2025 7 a.m. PST",1489,1460,821,-668
SCL,"1/23/2025 8 a.m. PST",1623,1589,827,-796
SCL,"1/23/2025 9 a.m. PST",1640,1609,766,-874
SCL,"1/23/2025 10 a.m. PST",1590,1588,581,-1009
SCL,"1/23/2025 11 a.m. PST",1527,1559,569,-958
SCL,"1/23/2025 12 p.m. PST",1481,1532,499,-982
SCL,"1/23/2025 1 p.m. PST",1454,1512,488,-966
SCL,"1/23/2025 2 p.m. PST",1443,1480,478,-965
SCL,"1/23/2025 3 p.m. PST",1429,1467,483,-946
SCL,"1/23/2025 4 p.m. PST",1442,1474,601,-841
SCL,"1/23/2025 5 p.m. PST",1484,1516,837,-647
SCL,"1/23/2025 6 p.m. PST",1546,1580,832,-714
SCL,"1/23/2025 7 p.m. PST",1520,1559,878,-642
SCL,"1/23/2025 8 p.m. PST",1480,1517,870,-610
SCL,"1/23/2025 9 p.m. PST",1435,1475,828,-607
SCL,"1/23/2025 10 p.m. PST",1364,1406,814,-550
SCL,"1/23/2025 11 p.m. PST",1278,1312,656,-622
SCL,"1/24/2025 12 a.m. PST",1178,1231,613,-565
SCL,"1/24/2025 1 a.m. PST",1127,1133,518,-609
SCL,"1/24/2025 2 a.m. PST",1087,1085,481,-606
SCL,"1/24/2025 3 a.m. PST",1073,1070,478,-595
SCL,"1/24/2025 4 a.m. PST",1077,1080,500,-577
SCL,"1/24/2025 5 a.m. PST",1126,1133,560,-566
SCL,"1/24/2025 6 a.m. PST",1231,1242,690,-541
SCL,"1/24/2025 7 a.m. PST",1381,1396,778,-603
SCL,"1/24/2025 8 a.m. PST",1497,1516,963,-534
SCL,"1/24/2025 9 a.m. PST",1535,1559,927,-608
SCL,"1/24/2025 10 a.m. PST",1535,1556,821,-714
SCL,"1/24/2025 11 a.m. PST",1524,1544,671,-853
SCL,"1/24/2025 12 p.m. PST",1478,1529,672,-806
SCL,"1/24/2025 1 p.m. PST",1444,1508,676,-768
SCL,"1/24/2025 2 p.m. PST",1409,1487,672,-737
SCL,"1/24/2025 3 p.m. PST",1389,1475,675,-714
SCL,"1/24/2025 4 p.m. PST",1395,1481,691,-704
SCL,"1/24/2025 5 p.m. PST",1431,1516,791,-640
SCL,"1/24/2025 6 p.m. PST",1525,1581,887,-638
SCL,"1/24/2025 7 p.m. PST",1507,1546,892,-615
SCL,"1/24/2025 8 p.m. PST",1477,1499,817,-660
SCL,"1/24/2025 9 p.m. PST",1439,1454,779,-660
SCL,"1/24/2025 10 p.m. PST",1390,1393,641,-749
SCL,"1/24/2025 11 p.m. PST",1289,1319,648,-641
SCL,"1/25/2025 12 a.m. PST",1231,1247,600,-631
SCL,"1/25/2025 1 a.m. PST",1219,1167,575,-644
SCL,"1/25/2025 2 a.m. PST",1189,1140,533,-656
SCL,"1/25/2025 3 a.m. PST",1173,1124,583,-590
SCL,"1/25/2025 4 a.m. PST",1180,1119,610,-570
SCL,"1/25/2025 5 a.m. PST",1183,1128,663,-520
SCL,"1/25/2025 6 a.m. PST",1252,1168,714,-538
SCL,"1/25/2025 7 a.m. PST",1326,1240,802,-524
SCL,"1/25/2025 8 a.m. PST",1405,1305,902,-503
SCL,"1/25/2025 9 a.m. PST",1478,1357,919,-559
SCL,"1/25/2025 10 a.m. PST",1487,1383,699,-788
SCL,"1/25/2025 11 a.m. PST",1427,1384,538,-889
SCL,"1/25/2025 12 p.m. PST",1435,1371,535,-900
SCL,"1/25/2025 1 p.m. PST",1375,1347,534,-841
SCL,"1/25/2025 2 p.m. PST",1328,1319,535,-793
SCL,"1/25/2025 3 p.m. PST",1325,1296,537,-788
SCL,"1/25/2025 4 p.m. PST",1337,1311,673,-664
SCL,"1/25/2025 5 p.m. PST",1379,1360,801,-578
SCL,"1/25/2025 6 p.m. PST",1473,1433,886,-587
SCL,"1/25/2025 7 p.m. PST",1494,1432,898,-596
SCL,"1/25/2025 8 p.m. PST",1474,1413,913,-561
SCL,"1/25/2025 9 p.m. PST",1456,1382,828,-628
SCL,"1/25/2025 10 p.m. PST",1404,1333,828,-576
SCL,"1/25/2025 11 p.m. PST",1357,1265,793,-564
SCL,"1/26/2025 12 a.m. PST",1297,1198,758,-539
SCL,"1/26/2025 1 a.m. PST",1245,1196,672,-573
SCL,"1/26/2025 2 a.m. PST",1219,1172,613,-606
SCL,"1/26/2025 3 a.m. PST",1195,1156,586,-609
SCL,"1/26/2025 4 a.m. PST",1203,1149,586,-617
SCL,"1/26/2025 5 a.m. PST",1220,1150,606,-614
SCL,"1/26/2025 6 a.m. PST",1252,1177,654,-598
SCL,"1/26/2025 7 a.m. PST",1326,1226,722,-604
SCL,"1/26/2025 8 a.m. PST",1394,1278,820,-574
SCL,"1/26/2025 9 a.m. PST",1459,1311,745,-714
SCL,"1/26/2025 10 a.m. PST",1480,1342,493,-987
SCL,"1/26/2025 11 a.m. PST",1460,1358,413,-1047
SCL,"1/26/2025 12 p.m. PST",1412,1357,392,-1020
SCL,"1/26/2025 1 p.m. PST",1396,1345,377,-1019
SCL,"1/26/2025 2 p.m. PST",1373,1328,380,-993
SCL,"1/26/2025 3 p.m. PST",1340,1313,366,-974
SCL,"1/26/2025 4 p.m. PST",1350,1330,739,-611
SCL,"1/26/2025 5 p.m. PST",1390,1374,800,-590
SCL,"1/26/2025 6 p.m. PST",1485,1459,956,-529
SCL,"1/26/2025 7 p.m. PST",1521,1469,953,-568
SCL,"1/26/2025 8 p.m. PST",1527,1466,972,-555
SCL,"1/26/2025 9 p.m. PST",1499,1430,931,-568
SCL,"1/26/2025 10 p.m. PST",1429,1369,830,-599
SCL,"1/26/2025 11 p.m. PST",1320,1293,830,-490
SCL,"1/27/2025 12 a.m. PST",1156,1213,749,-407
SCL,"1/27/2025 1 a.m. PST",1220,1166,586,-634
SCL,"1/27/2025 2 a.m. PST",1190,1143,594,-596
SCL,"1/27/2025 3 a.m. PST",1208,1137,585,-623
SCL,"1/27/2025 4 a.m. PST",1223,1154,603,-620
SCL,"1/27/2025 5 a.m. PST",1285,1204,674,-611
SCL,"1/27/2025 6 a.m. PST",1391,1309,918,-473
SCL,"1/27/2025 7 a.m. PST",1552,1457,963,-589
SCL,"1/27/2025 8 a.m. PST",1693,1573,1028,-665
SCL,"1/27/2025 9 a.m. PST",1700,1599,995,-705
SCL,"1/27/2025 10 a.m. PST",1645,1578,891,-754
SCL,"1/27/2025 11 a.m. PST",1566,1550,694,-872
SCL,"1/27/2025 12 p.m. PST",1491,1519,690,-801
SCL,"1/27/2025 1 p.m. PST",1443,1478,715,-728
SCL,"1/27/2025 2 p.m. PST",1400,1441,654,-746
SCL,"1/27/2025 3 p.m. PST",1366,1424,672,-694
SCL,"1/27/2025 4 p.m. PST",1363,1404,693,-670
SCL,"1/27/2025 5 p.m. PST",1398,1453,823,-575
SCL,"1/27/2025 6 p.m. PST",1492,1534,956,-536
SCL,"1/27/2025 7 p.m. PST",1517,1530,936,-581
SCL,"1/27/2025 8 p.m. PST",1493,1490,916,-577
SCL,"1/27/2025 9 p.m. PST",1457,1450,882,-575
SCL,"1/27/2025 10 p.m. PST",1394,1387,790,-604
SCL,"1/27/2025 11 p.m. PST",1307,1288,672,-635
SCL,"1/28/2025 12 a.m. PST",1213,1210,529,-684
SCL,"1/28/2025 1 a.m. PST",1163,1169,605,-558
SCL,"1/28/2025 2 a.m. PST",1145,1126,592,-553
SCL,"1/28/2025 3 a.m. PST",1138,1116,585,-553
SCL,"1/28/2025 4 a.m. PST",1161,1128,584,-577
SCL,"1/28/2025 5 a.m. PST",1214,1176,632,-582
SCL,"1/28/2025 6 a.m. PST",1311,1289,708,-603
SCL,"1/28/2025 7 a.m. PST",1480,1451,908,-572
SCL,"1/28/2025 8 a.m. PST",1615,1568,836,-779
SCL,"1/28/2025 9 a.m. PST",1630,1586,814,-816
SCL,"1/28/2025 10 a.m. PST",1575,1561,809,-766
SCL,"1/28/2025 11 a.m. PST",1511,1529,509,-1002
SCL,"1/28/2025 12 p.m. PST",1459,1496,497,-962
SCL,"1/28/2025 1 p.m. PST",1413,1472,467,-946
SCL,"1/28/2025 2 p.m. PST",1378,1436,419,-959
SCL,"1/28/2025 3 p.m. PST",1327,1406,456,-871
SCL,"1/28/2025 4 p.m. PST",1326,1415,715,-611
SCL,"1/28/2025 5 p.m. PST",1373,1455,745,-628
SCL,"1/28/2025 6 p.m. PST",1472,1533,808,-664
SCL,"1/28/2025 7 p.m. PST",1491,1534,828,-663
SCL,"1/28/2025 8 p.m. PST",1481,1500,805,-676
SCL,"1/28/2025 9 p.m. PST",1444,1459,802,-642
SCL,"1/28/2025 10 p.m. PST",1384,1394,801,-583
SCL,"1/28/2025 11 p.m. PST",1301,1298,764,-537
SCL,"1/29/2025 12 a.m. PST",1220,1218,646,-574
SCL,"1/29/2025 1 a.m. PST",1165,1168,616,-549
SCL,"1/29/2025 2 a.m. PST",1141,1127,615,-526
SCL,"1/29/2025 3 a.m. PST",1136,1117,616,-520
SCL,"1/29/2025 4 a.m. PST",1150,1128,617,-533
SCL,"1/29/2025 5 a.m. PST",1203,1171,633,-570
SCL,"1/29/2025 6 a.m. PST",1311,1278,791,-520
SCL,"1/29/2025 7 a.m. PST",1474,1433,927,-547
SCL,"1/29/2025 8 a.m. PST",1594,1539,1050,-544
SCL,"1/29/2025 9 a.m. PST",1617,1553,959,-658
SCL,"1/29/2025 10 a.m. PST",1607,1531,853,-754
SCL,"1/29/2025 11 a.m. PST",1573,1495,652,-921
SCL,"1/29/2025 12 p.m. PST",1505,1461,611,-894
SCL,"1/29/2025 1 p.m. PST",1429,1434,550,-879
SCL,"1/29/2025 2 p.m. PST",1367,1404,516,-851
SCL,"1/29/2025 3 p.m. PST",1333,1377,494,-839
SCL,"1/29/2025 4 p.m. PST",1327,1366,560,-767
SCL,"1/29/2025 5 p.m. PST",1356,1420,775,-581
SCL,"1/29/2025 6 p.m. PST",1447,1490,824,-623
SCL,"1/29/2025 7 p.m. PST",1472,1493,821,-651
SCL,"1/29/2025 8 p.m. PST",1455,1470,814,-641
SCL,"1/29/2025 9 p.m. PST",1427,1430,807,-620
SCL,"1/29/2025 10 p.m. PST",1378,1362,800,-578
SCL,"1/29/2025 11 p.m. PST",1286,1274,725,-561
SCL,"1/30/2025 12 a.m. PST",1195,1191,651,-544
SCL,"1/30/2025 1 a.m. PST",1140,1149,627,-513
SCL,"1/30/2025 2 a.m. PST",1113,1106,624,-489
SCL,"1/30/2025 3 a.m. PST",1098,1094,607,-491
SCL,"1/30/2025 4 a.m. PST",1105,1103,604,-501
SCL,"1/30/2025 5 a.m. PST",1151,1146,636,-515
SCL,"1/30/2025 6 a.m. PST",1256,1250,839,-417
SCL,"1/30/2025 7 a.m. PST",1401,1400,937,-464
SCL,"1/30/2025 8 a.m. PST",1520,1515,1088,-432
SCL,"1/30/2025 9 a.m. PST",1547,1537,1036,-511
SCL,"1/30/2025 10 a.m. PST",1542,1526,914,-628
SCL,"1/30/2025 11 a.m. PST",1530,1504,659,-871
SCL,"1/30/2025 12 p.m. PST",1518,1483,631,-887
SCL,"1/30/2025 1 p.m. PST",1471,1467,611,-860
SCL,"1/30/2025 2 p.m. PST",1434,1450,543,-891
SCL,"1/30/2025 3 p.m. PST",1422,1432,476,-946
SCL,"1/30/2025 4 p.m. PST",1419,1420,499,-920
SCL,"1/30/2025 5 p.m. PST",1467,1465,816,-651
SCL,"1/30/2025 6 p.m. PST",1522,1521,1013,-509
SCL,"1/30/2025 7 p.m. PST",1488,1506,1004,-484
SCL,"1/30/2025 8 p.m. PST",1452,1474,961,-491
SCL,"1/30/2025 9 p.m. PST",1400,1427,798,-602
SCL,"1/30/2025 10 p.m. PST",1337,1359,794,-543
SCL,"1/30/2025 11 p.m. PST",1249,1268,774,-475
SCL,"1/31/2025 12 a.m. PST",1159,1185,597,-562
SCL,"1/31/2025 1 a.m. PST",1097,1108,565,-532
SCL,"1/31/2025 2 a.m. PST",1052,1072,545,-507
SCL,"1/31/2025 3 a.m. PST",1033,1055,540,-493
SCL,"1/31/2025 4 a.m. PST",1036,1059,543,-493
SCL,"1/31/2025 5 a.m. PST",1076,1098,547,-529
SCL,"1/31/2025 6 a.m. PST",1166,1192,757,-409
SCL,"1/31/2025 7 a.m. PST",1308,1324,898,-410
SCL,"1/31/2025 8 a.m. PST",1409,1432,884,-525
SCL,"1/31/2025 9 a.m. PST",1431,1469,799,-632
SCL,"1/31/2025 10 a.m. PST",1425,1470,747,-678
SCL,"1/31/2025 11 a.m. PST",1424,1458,778,-646
SCL,"1/31/2025 12 p.m. PST",1410,1441,733,-677
SCL,"1/31/2025 1 p.m. PST",1400,1428,627,-773
SCL,"1/31/2025 2 p.m. PST",1418,1404,578,-840
SCL,"1/31/2025 3 p.m. PST",1430,1382,594,-836
SCL,"1/31/2025 4 p.m. PST",1424,1393,583,-841
SCL,"1/31/2025 5 p.m. PST",1443,1425,677,-766
SCL,"1/31/2025 6 p.m. PST",1462,1470,791,-671
SCL,"1/31/2025 7 p.m. PST",1423,1442,741,-682
SCL,"1/31/2025 8 p.m. PST",1378,1397,778,-600
SCL,"1/31/2025 9 p.m. PST",1336,1357,690,-646
SCL,"1/31/2025 10 p.m. PST",1311,1310,692,-619
SCL,"1/31/2025 11 p.m. PST",1261,1252,658,-603