"BA Code","Timestamp (Hour Ending)","Demand (MWh)","Demand Forecast (MWh)","Net Generation (MWh)","Total Interchange (MWh)"
SCL,"12/1/2024 12 a.m. PST",1092,1137,78,-1014
SCL,"12/1/2024 1 a.m. PST",1055,1055,82,-973
SCL,"12/1/2024 2 a.m. PST",1022,1023,83,-939
SCL,"12/1/2024 3 a.m. PST",999,1004,79,-920
SCL,"12/1/2024 4 a.m. PST",998,1003,139,-859
SCL,"12/1/2024 5 a.m. PST",1017,1021,129,-888
SCL,"12/1/2024 6 a.m. PST",1051,1066,167,-884
SCL,"12/1/2024 7 a.m. PST",1111,1134,272,-839
SCL,"12/1/2024 8 a.m. PST",1179,1204,331,-848
SCL,"12/1/2024 9 a.m. PST",1225,1250,335,-890
SCL,"12/1/2024 10 a.m. PST",1233,1276,249,-984
SCL,"12/1/2024 11 a.m. PST",1226,1285,201,-1025
SCL,"12/1/2024 12 p.m. PST",1214,1282,194,-1020
SCL,"12/1/2024 1 p.m. PST",1188,1266,190,-998
SCL,"12/1/2024 2 p.m. PST",1183,1250,191,-992
SCL,"12/1/2024 3 p.m. PST",1171,1244,196,-975
SCL,"12/1/2024 4 p.m. PST",1186,1272,503,-683
SCL,"12/1/2024 5 p.m. PST",1272,1339,547,-725
SCL,"12/1/2024 6 p.m. PST",1343,1394,603,-740
SCL,"12/1/2024 7 p.m. PST",1355,1393,635,-720
SCL,"12/1/2024 8 p.m. PST",1339,1378,645,-694
SCL,"12/1/2024 9 p.m. PST",1315,1351,489,-826
SCL,"12/1/2024 10 p.m. PST",1269,1307,239,-1030
SCL,"12/1/2024 11 p.m. PST",1185,1232,89,-1096
SCL,"12/2/2024 12 a.m. PST",1115,1158,86,-1029
SCL,"12/2/2024 1 a.m. PST",1069,1067,83,-986
SCL,"12/2/2024 2 a.m. PST",1042,1037,85,-957
SCL,"12/2/2024 3 a.m. PST",1036,1029,87,-949
SCL,"12/2/2024 4 a.m. PST",1048,1046,159,-889
SCL,"12/2/2024 5 a.m. PST",1094,1106,225,-869
SCL,"12/2/2024 6 a.m. PST",1191,1223,321,-870
SCL,"12/2/2024 7 a.m. PST",1339,1369,569,-770
SCL,"12/2/2024 8 a.m. PST",1462,1480,634,-828
SCL,"12/2/2024 9 a.m. PST",1491,1506,458,-1033
SCL,"12/2/2024 10 a.m. PST",1490,1497,287,-1203
SCL,"12/2/2024 11 a.m. PST",1468,1481,276,-1192
SCL,"12/2/2024 12 p.m. PST",1454,1457,273,-1181
SCL,"12/2/2024 1 p.m. PST",1432,1436,274,-1158
SCL,"12/2/2024 2 p.m. PST",1398,1409,290,-1108
SCL,"12/2/2024 3 p.m. PST",1371,1396,260,-1111
SCL,"12/2/2024 4 p.m. PST",1393,1414,470,-923
SCL,"12/2/2024 5 p.m. PST",1466,1480,645,-821
SCL,"12/2/2024 6 p.m. PST",1501,1520,677,-824
SCL,"12/2/2024 7 p.m. PST",1470,1500,653,-817
SCL,"12/2/2024 8 p.m. PST",1439,1453,599,-840
SCL,"12/2/2024 9 p.m. PST",1390,1413,511,-879
SCL,"12/2/2024 10 p.m. PST",1331,1352,469,-862
SCL,"12/2/2024 11 p.m. PST",1238,1255,194,-1044
SCL,"12/3/2024 12 a.m. PST",1155,1172,161,-994
SCL,"12/3/2024 1 a.m. PST",1094,1107,117,-977
SCL,"12/3/2024 2 a.m. PST",1063,1072,103,-960
SCL,"12/3/2024 3 a.m. PST",1048,1060,113,-935
SCL,"12/3/2024 4 a.m. PST",1059,1071,227,-832
SCL,"12/3/2024 5 a.m. PST",1103,1126,216,-887
SCL,"12/3/2024 6 a.m. PST",1204,1240,336,-868
SCL,"12/3/2024 7 a.m. PST",1359,1401,617,-742
SCL,"12/3/2024 8 a.m. PST",1472,1524,588,-884
SCL,"12/3/2024 9 a.m. PST",1502,1545,482,-1020
SCL,"12/3/2024 10 a.m. PST",1495,1520,396,-1099
SCL,"12/3/2024 11 a.m. PST",1466,1477,222,-1244
SCL,"12/3/2024 12 p.m. PST",1431,1444,240,-1191
SCL,"12/3/2024 1 p.m. PST",1398,1414,238,-1160
SCL,"12/3/2024 2 p.m. PST",1363,1387,244,-1119
SCL,"12/3/2024 3 p.m. PST",1346,1362,245,-1101
SCL,"12/3/2024 4 p.m. PST",1371,1385,520,-851
SCL,"12/3/2024 5 p.m. PST",1438,1460,631,-807
SCL,"12/3/2024 6 p.m. PST",1507,1513,611,-896
SCL,"12/3/2024 7 p.m. PST",1496,1494,626,-870
SCL,"12/3/2024 8 p.m. PST",1478,1466,634,-844
SCL,"12/3/2024 9 p.m. PST",1447,1430,592,-855
SCL,"12/3/2024 10 p.m. PST",1385,1368,434,-951
SCL,"12/3/2024 11 p.m. PST",1298,1281,285,-1013
SCL,"12/4/2024 12 a.m. PST",1205,1193,165,-1040
SCL,"12/4/2024 1 a.m. PST",1142,1163,121,-1021
SCL,"12/4/2024 2 a.m. PST",1109,1119,107,-1002
SCL,"12/4/2024 3 a.m. PST",1092,1106,106,-986
SCL,"12/4/2024 4 a.m. PST",1099,1112,111,-988
SCL,"12/4/2024 5 a.m. PST",1155,1154,296,-859
SCL,"12/4/2024 6 a.m. PST",1256,1257,513,-743
SCL,"12/4/2024 7 a.m. PST",1418,1406,778,-640
SCL,"12/4/2024 8 a.m. PST",1546,1520,752,-794
SCL,"12/4/2024 9 a.m. PST",1575,1534,658,-917
SCL,"12/4/2024 10 a.m. PST",1549,1507,563,-986
SCL,"12/4/2024 11 a.m. PST",1496,1462,395,-1101
SCL,"12/4/2024 12 p.m. PST",1449,1421,391,-1058
SCL,"12/4/2024 1 p.m. PST",1441,1387,393,-1048
SCL,"12/4/2024 2 p.m. PST",1416,1358,392,-1024
SCL,"12/4/2024 3 p.m. PST",1394,1340,398,-996
SCL,"12/4/2024 4 p.m. PST",1400,1365,661,-739
SCL,"12/4/2024 5 p.m. PST",1485,1437,686,-799
SCL,"12/4/2024 6 p.m. PST",1545,1483,690,-855
SCL,"12/4/2024 7 p.m. PST",1530,1472,672,-858
SCL,"12/4/2024 8 p.m. PST",1505,1440,656,-849
SCL,"12/4/2024 9 p.m. PST",1478,1407,681,-797
SCL,"12/4/2024 10 p.m. PST",1406,1348,456,-950
SCL,"12/4/2024 11 p.m. PST",1318,1258,463,-855
SCL,"12/5/2024 12 a.m. PST",1220,1176,291,-929
SCL,"12/5/2024 1 a.m. PST",1152,1170,105,-1047
SCL,"12/5/2024 2 a.m. PST",1120,1127,178,-942
SCL,"12/5/2024 3 a.m. PST",1106,1110,111,-995
SCL,"12/5/2024 4 a.m. PST",1119,1115,113,-1006
SCL,"12/5/2024 5 a.m. PST",1164,1155,287,-877
SCL,"12/5/2024 6 a.m. PST",1273,1258,364,-909
SCL,"12/5/2024 7 a.m. PST",1431,1409,776,-655
SCL,"12/5/2024 8 a.m. PST",1552,1523,706,-846
SCL,"12/5/2024 9 a.m. PST",1571,1548,662,-909
SCL,"12/5/2024 10 a.m. PST",1534,1524,493,-1041
SCL,"12/5/2024 11 a.m. PST",1514,1481,480,-1034
SCL,"12/5/2024 12 p.m. PST",1455,1443,476,-979
SCL,"12/5/2024 1 p.m. PST",1388,1407,275,-1113
SCL,"12/5/2024 2 p.m. PST",1408,1379,271,-1137
SCL,"12/5/2024 3 p.m. PST",1387,1362,261,-1126
SCL,"12/5/2024 4 p.m. PST",1362,1385,520,-842
SCL,"12/5/2024 5 p.m. PST",1427,1452,610,-817
SCL,"12/5/2024 6 p.m. PST",1446,1497,636,-810
SCL,"12/5/2024 7 p.m. PST",1414,1472,625,-789
SCL,"12/5/2024 8 p.m. PST",1372,1440,565,-807
SCL,"12/5/2024 9 p.m. PST",1332,1407,439,-893
SCL,"12/5/2024 10 p.m. PST",1274,1349,435,-839
SCL,"12/5/2024 11 p.m. PST",1186,1261,454,-732
SCL,"12/6/2024 12 a.m. PST",1101,1176,272,-829
SCL,"12/6/2024 1 a.m. PST",1038,1051,225,-813
SCL,"12/6/2024 2 a.m. PST",1008,1015,273,-735
SCL,"12/6/2024 3 a.m. PST",993,997,272,-721
SCL,"12/6/2024 4 a.m. PST",1005,1005,279,-726
SCL,"12/6/2024 5 a.m. PST",1050,1056,295,-755
SCL,"12/6/2024 6 a.m. PST",1153,1163,486,-667
SCL,"12/6/2024 7 a.m. PST",1308,1309,705,-603
SCL,"12/6/2024 8 a.m. PST",1443,1425,660,-783
SCL,"12/6/2024 9 a.m. PST",1466,1460,625,-841
SCL,"12/6/2024 10 a.m. PST",1446,1465,479,-967
SCL,"12/6/2024 11 a.m. PST",1463,1456,376,-1087
SCL,"12/6/2024 12 p.m. PST",1415,1441,246,-1169
SCL,"12/6/2024 1 p.m. PST",1390,1422,231,-1159
SCL,"12/6/2024 2 p.m. PST",1386,1404,236,-1150
SCL,"12/6/2024 3 p.m. PST",1381,1379,235,-1146
SCL,"12/6/2024 4 p.m. PST",1393,1395,684,-709
SCL,"12/6/2024 5 p.m. PST",1430,1450,740,-690
SCL,"12/6/2024 6 p.m. PST",1443,1467,770,-673
SCL,"12/6/2024 7 p.m. PST",1382,1425,730,-652
SCL,"12/6/2024 8 p.m. PST",1338,1381,701,-637
SCL,"12/6/2024 9 p.m. PST",1294,1339,613,-681
SCL,"12/6/2024 10 p.m. PST",1239,1286,431,-808
SCL,"12/6/2024 11 p.m. PST",1173,1217,268,-905
SCL,"12/7/2024 12 a.m. PST",1104,1142,272,-832
SCL,"12/7/2024 1 a.m. PST",1045,1019,100,-945
SCL,"12/7/2024 2 a.m. PST",1004,971,100,-904
SCL,"12/7/2024 3 a.m. PST",974,946,100,-874
SCL,"12/7/2024 4 a.m. PST",955,939,100,-855
SCL,"12/7/2024 5 a.m. PST",964,954,105,-859
SCL,"12/7/2024 6 a.m. PST",1003,995,107,-896
SCL,"12/7/2024 7 a.m. PST",1056,1057,258,-798
SCL,"12/7/2024 8 a.m. PST",1102,1126,207,-895
SCL,"12/7/2024 9 a.m. PST",1173,1187,399,-774
SCL,"12/7/2024 10 a.m. PST",1241,1234,523,-718
SCL,"12/7/2024 11 a.m. PST",1264,1258,485,-779
SCL,"12/7/2024 12 p.m. PST",1285,1270,246,-1039
SCL,"12/7/2024 1 p.m. PST",1286,1271,188,-1098
SCL,"12/7/2024 2 p.m. PST",1253,1265,187,-1066
SCL,"12/7/2024 3 p.m. PST",1227,1257,207,-1020
SCL,"12/7/2024 4 p.m. PST",1200,1261,256,-944
SCL,"12/7/2024 5 p.m. PST",1275,1307,601,-674
SCL,"12/7/2024 6 p.m. PST",1327,1333,665,-662
SCL,"12/7/2024 7 p.m. PST",1306,1318,507,-799
SCL,"12/7/2024 8 p.m. PST",1288,1291,510,-778
SCL,"12/7/2024 9 p.m. PST",1244,1262,506,-738
SCL,"12/7/2024 10 p.m. PST",1220,1221,336,-884
SCL,"12/7/2024 11 p.m. PST",1171,1165,166,-1005
SCL,"12/8/2024 12 a.m. PST",1109,1103,136,-973
SCL,"12/8/2024 1 a.m. PST",1057,1025,231,-826
SCL,"12/8/2024 2 a.m. PST",1020,988,211,-809
SCL,"12/8/2024 3 a.m. PST",988,965,236,-752
SCL,"12/8/2024 4 a.m. PST",972,955,234,-738
SCL,"12/8/2024 5 a.m. PST",976,956,218,-758
SCL,"12/8/2024 6 a.m. PST",1008,983,228,-780
SCL,"12/8/2024 7 a.m. PST",1053,1035,193,-860
SCL,"12/8/2024 8 a.m. PST",1119,1091,212,-907
SCL,"12/8/2024 9 a.m. PST",1175,1142,248,-927
SCL,"12/8/2024 10 a.m. PST",1223,1177,248,-975
SCL,"12/8/2024 11 a.m. PST",1252,1200,246,-1006
SCL,"12/8/2024 12 p.m. PST",1276,1207,250,-1026
SCL,"12/8/2024 1 p.m. PST",1282,1209,250,-1032
SCL,"12/8/2024 2 p.m. PST",1275,1210,245,-1030
SCL,"12/8/2024 3 p.m. PST",1275,1215,251,-1024
SCL,"12/8/2024 4 p.m. PST",1266,1236,299,-967
SCL,"12/8/2024 5 p.m. PST",1326,1286,464,-862
SCL,"12/8/2024 6 p.m. PST",1383,1339,541,-842
SCL,"12/8/2024 7 p.m. PST",1376,1335,548,-828
SCL,"12/8/2024 8 p.m. PST",1355,1310,550,-805
SCL,"12/8/2024 9 p.m. PST",1307,1284,466,-841
SCL,"12/8/2024 10 p.m. PST",1264,1241,363,-901
SCL,"12/8/2024 11 p.m. PST",1182,1168,364,-818
SCL,"12/9/2024 12 a.m. PST",1092,1084,192,-900
SCL,"12/9/2024 1 a.m. PST",1034,1007,196,-838
SCL,"12/9/2024 2 a.m. PST",999,965,206,-793
SCL,"12/9/2024 3 a.m. PST",990,954,209,-781
SCL,"12/9/2024 4 a.m. PST",1000,967,280,-720
SCL,"12/9/2024 5 a.m. PST",1045,1016,282,-763
SCL,"12/9/2024 6 a.m. PST",1141,1120,353,-788
SCL,"12/9/2024 7 a.m. PST",1251,1256,513,-738
SCL,"12/9/2024 8 a.m. PST",1367,1364,544,-823
SCL,"12/9/2024 9 a.m. PST",1405,1394,481,-924
SCL,"12/9/2024 10 a.m. PST",1388,1391,425,-963
SCL,"12/9/2024 11 a.m. PST",1372,1381,375,-997
SCL,"12/9/2024 12 p.m. PST",1382,1366,374,-1008
SCL,"12/9/2024 1 p.m. PST",1393,1353,289,-1104
SCL,"12/9/2024 2 p.m. PST",1378,1328,287,-1091
SCL,"12/9/2024 3 p.m. PST",1336,1320,372,-964
SCL,"12/9/2024 4 p.m. PST",1331,1341,423,-908
SCL,"12/9/2024 5 p.m. PST",1398,1402,705,-693
SCL,"12/9/2024 6 p.m. PST",1457,1449,728,-729
SCL,"12/9/2024 7 p.m. PST",1455,1423,717,-738
SCL,"12/9/2024 8 p.m. PST",1426,1377,766,-660
SCL,"12/9/2024 9 p.m. PST",1396,1336,635,-761
SCL,"12/9/2024 10 p.m. PST",1337,1278,477,-860
SCL,"12/9/2024 11 p.m. PST",1233,1191,449,-784
SCL,"12/10/2024 12 a.m. PST",1123,1110,378,-745
SCL,"12/10/2024 1 a.m. PST",1065,1079,110,-955
SCL,"12/10/2024 2 a.m. PST",1036,1038,109,-927
SCL,"12/10/2024 3 a.m. PST",1035,1025,116,-919
SCL,"12/10/2024 4 a.m. PST",1046,1033,109,-937
SCL,"12/10/2024 5 a.m. PST",1104,1077,131,-973
SCL,"12/10/2024 6 a.m. PST",1213,1185,360,-853
SCL,"12/10/2024 7 a.m. PST",1379,1335,573,-806
SCL,"12/10/2024 8 a.m. PST",1504,1447,677,-827
SCL,"12/10/2024 9 a.m. PST",1519,1458,662,-857
SCL,"12/10/2024 10 a.m. PST",1479,1434,525,-954
SCL,"12/10/2024 11 a.m. PST",1446,1396,427,-1019
SCL,"12/10/2024 12 p.m. PST",1406,1369,382,-1024
SCL,"12/10/2024 1 p.m. PST",1368,1342,320,-1048
SCL,"12/10/2024 2 p.m. PST",1347,1316,309,-1038
SCL,"12/10/2024 3 p.m. PST",1360,1298,312,-1048
SCL,"12/10/2024 4 p.m. PST",1384,1319,398,-986
SCL,"12/10/2024 5 p.m. PST",1449,1384,546,-903
SCL,"12/10/2024 6 p.m. PST",1490,1434,707,-783
SCL,"12/10/2024 7 p.m. PST",1465,1416,571,-894
SCL,"12/10/2024 8 p.m. PST",1435,1382,553,-882
SCL,"12/10/2024 9 p.m. PST",1396,1349,547,-849
SCL,"12/10/2024 10 p.m. PST",1327,1290,400,-927
SCL,"12/10/2024 11 p.m. PST",1237,1200,385,-852
SCL,"12/11/2024 12 a.m. PST",1149,1115,233,-916
SCL,"12/11/2024 1 a.m. PST",1089,1102,106,-983
SCL,"12/11/2024 2 a.m. PST",1046,1064,104,-942
SCL,"12/11/2024 3 a.m. PST",1033,1048,103,-930
SCL,"12/11/2024 4 a.m. PST",1036,1052,104,-932
SCL,"12/11/2024 5 a.m. PST",1075,1091,109,-966
SCL,"12/11/2024 6 a.m. PST",1194,1189,395,-799
SCL,"12/11/2024 7 a.m. PST",1372,1330,606,-766
SCL,"12/11/2024 8 a.m. PST",1444,1441,701,-743
SCL,"12/11/2024 9 a.m. PST",1467,1460,629,-838
SCL,"12/11/2024 10 a.m. PST",1460,1440,547,-913
SCL,"12/11/2024 11 a.m. PST",1436,1404,506,-930
SCL,"12/11/2024 12 p.m. PST",1411,1372,329,-1082
SCL,"12/11/2024 1 p.m. PST",1377,1344,326,-1051
SCL,"12/11/2024 2 p.m. PST",1353,1326,335,-1018
SCL,"12/11/2024 3 p.m. PST",1319,1300,405,-914
SCL,"12/11/2024 4 p.m. PST",1326,1329,542,-784
SCL,"12/11/2024 5 p.m. PST",1400,1392,679,-721
SCL,"12/11/2024 6 p.m. PST",1441,1444,757,-684
SCL,"12/11/2024 7 p.m. PST",1424,1425,657,-767
SCL,"12/11/2024 8 p.m. PST",1412,1401,613,-799
SCL,"12/11/2024 9 p.m. PST",1375,1368,645,-730
SCL,"12/11/2024 10 p.m. PST",1324,1309,479,-845
SCL,"12/11/2024 11 p.m. PST",1239,1226,416,-823
SCL,"12/12/2024 12 a.m. PST",1144,1138,237,-907
SCL,"12/12/2024 1 a.m. PST",1095,1102,220,-875
SCL,"12/12/2024 2 a.m. PST",1054,1061,216,-838
SCL,"12/12/2024 3 a.m. PST",1044,1046,208,-836
SCL,"12/12/2024 4 a.m. PST",1043,1051,221,-822
SCL,"12/12/2024 5 a.m. PST",1088,1088,245,-843
SCL,"12/12/2024 6 a.m. PST",1206,1184,370,-836
SCL,"12/12/2024 7 a.m. PST",1351,1325,400,-951
SCL,"12/12/2024 8 a.m. PST",1441,1433,544,-897
SCL,"12/12/2024 9 a.m. PST",1469,1451,486,-983
SCL,"12/12/2024 10 a.m. PST",1458,1447,380,-1078
SCL,"12/12/2024 11 a.m. PST",1428,1429,371,-1057
SCL,"12/12/2024 12 p.m. PST",1422,1415,371,-1051
SCL,"12/12/2024 1 p.m. PST",1404,1407,378,-1026
SCL,"12/12/2024 2 p.m. PST",1383,1403,369,-1014
SCL,"12/12/2024 3 p.m. PST",1380,1394,373,-1007
SCL,"12/12/2024 4 p.m. PST",1384,1394,574,-810
SCL,"12/12/2024 5 p.m. PST",1418,1460,646,-772
SCL,"12/12/2024 6 p.m. PST",1441,1487,642,-799
SCL,"12/12/2024 7 p.m. PST",1401,1462,644,-757
SCL,"12/12/2024 8 p.m. PST",1366,1420,627,-739
SCL,"12/12/2024 9 p.m. PST",1317,1379,552,-765
SCL,"12/12/2024 10 p.m. PST",1253,1319,544,-709
SCL,"12/12/2024 11 p.m. PST",1173,1237,529,-644
SCL,"12/13/2024 12 a.m. PST",1086,1151,377,-709
SCL,"12/13/2024 1 a.m. PST",1018,1042,112,-906
SCL,"12/13/2024 2 a.m. PST",979,998,110,-869
SCL,"12/13/2024 3 a.m. PST",966,981,109,-857
SCL,"12/13/2024 4 a.m. PST",970,987,105,-865
SCL,"12/13/2024 5 a.m. PST",1013,1036,117,-896
SCL,"12/13/2024 6 a.m. PST",1112,1145,298,-814
SCL,"12/13/2024 7 a.m. PST",1246,1288,505,-741
SCL,"12/13/2024 8 a.m. PST",1359,1406,585,-774
SCL,"12/13/2024 9 a.m. PST",1392,1443,578,-814
SCL,"12/13/2024 10 a.m. PST",1397,1447,589,-808
SCL,"12/13/2024 11 a.m. PST",1405,1437,408,-997
SCL,"12/13/2024 12 p.m. PST",1419,1423,391,-1028
SCL,"12/13/2024 1 p.m. PST",1427,1405,385,-1042
SCL,"12/13/2024 2 p.m. PST",1437,1387,398,-1039
SCL,"12/13/2024 3 p.m. PST",1437,1371,395,-1042
SCL,"12/13/2024 4 p.m. PST",1421,1390,458,-963
SCL,"12/13/2024 5 p.m. PST",1474,1437,602,-872
SCL,"12/13/2024 6 p.m. PST",1492,1455,590,-902
SCL,"12/13/2024 7 p.m. PST",1421,1407,591,-830
SCL,"12/13/2024 8 p.m. PST",1396,1364,602,-794
SCL,"12/13/2024 9 p.m. PST",1345,1330,563,-782
SCL,"12/13/2024 10 p.m. PST",1298,1278,375,-923
SCL,"12/13/2024 11 p.m. PST",1227,1217,387,-840
SCL,"12/14/2024 12 a.m. PST",1155,1142,371,-784
SCL,"12/14/2024 1 a.m. PST",1094,1066,204,-890
SCL,"12/14/2024 2 a.m. PST",1029,1018,204,-825
SCL,"12/14/2024 3 a.m. PST",1017,994,206,-811
SCL,"12/14/2024 4 a.m. PST",997,984,247,-750
SCL,"12/14/2024 5 a.m. PST",1010,992,250,-760
SCL,"12/14/2024 6 a.m. PST",1050,1028,286,-764
SCL,"12/14/2024 7 a.m. PST",1108,1088,488,-620
SCL,"12/14/2024 8 a.m. PST",1177,1157,510,-667
SCL,"12/14/2024 9 a.m. PST",1227,1219,414,-813
SCL,"12/14/2024 10 a.m. PST",1275,1265,390,-885
SCL,"12/14/2024 11 a.m. PST",1260,1287,382,-878
SCL,"12/14/2024 12 p.m. PST",1300,1293,382,-918
SCL,"12/14/2024 1 p.m. PST",1292,1290,383,-909
SCL,"12/14/2024 2 p.m. PST",1287,1282,440,-847
SCL,"12/14/2024 3 p.m. PST",1293,1273,435,-858
SCL,"12/14/2024 4 p.m. PST",1298,1276,432,-866
SCL,"12/14/2024 5 p.m. PST",1346,1324,430,-916
SCL,"12/14/2024 6 p.m. PST",1387,1352,496,-891
SCL,"12/14/2024 7 p.m. PST",1364,1338,503,-861
SCL,"12/14/2024 8 p.m. PST",1340,1314,506,-834
SCL,"12/14/2024 9 p.m. PST",1310,1284,472,-838
SCL,"12/14/2024 10 p.m. PST",1270,1243,442,-828
SCL,"12/14/2024 11 p.m. PST",1216,1191,404,-812
SCL,"12/15/2024 12 a.m. PST",1161,1123,237,-924
SCL,"12/15/2024 1 a.m. PST",1106,1073,232,-874
SCL,"12/15/2024 2 a.m. PST",1059,1039,223,-836
SCL,"12/15/2024 3 a.m. PST",1042,1018,222,-820
SCL,"12/15/2024 4 a.m. PST",1040,1008,235,-805
SCL,"12/15/2024 5 a.m. PST",1040,1008,241,-799
SCL,"12/15/2024 6 a.m. PST",1067,1032,346,-721
SCL,"12/15/2024 7 a.m. PST",1125,1082,387,-738
SCL,"12/15/2024 8 a.m. PST",1180,1140,462,-718
SCL,"12/15/2024 9 a.m. PST",1245,1200,477,-768
SCL,"12/15/2024 10 a.m. PST",1266,1227,396,-870
SCL,"12/15/2024 11 a.m. PST",1278,1249,393,-885
SCL,"12/15/2024 12 p.m. PST",1274,1256,388,-886
SCL,"12/15/2024 1 p.m. PST",1267,1253,390,-877
SCL,"12/15/2024 2 p.m. PST",1239,1247,399,-840
SCL,"12/15/2024 3 p.m. PST",1253,1242,424,-829
SCL,"12/15/2024 4 p.m. PST",1276,1267,478,-798
SCL,"12/15/2024 5 p.m. PST",1361,1325,537,-824
SCL,"12/15/2024 6 p.m. PST",1407,1372,505,-902
SCL,"12/15/2024 7 p.m. PST",1415,1369,533,-882
SCL,"12/15/2024 8 p.m. PST",1403,1345,507,-896
SCL,"12/15/2024 9 p.m. PST",1367,1312,443,-924
SCL,"12/15/2024 10 p.m. PST",1309,1261,405,-904
SCL,"12/15/2024 11 p.m. PST",1231,1187,378,-853
SCL,"12/16/2024 12 a.m. PST",1126,1104,242,-884
SCL,"12/16/2024 1 a.m. PST",1081,1048,238,-843
SCL,"12/16/2024 2 a.m. PST",1049,1017,239,-810
SCL,"12/16/2024 3 a.m. PST",1042,1004,239,-803
SCL,"12/16/2024 4 a.m. PST",1055,1015,246,-809
SCL,"12/16/2024 5 a.m. PST",1103,1063,255,-848
SCL,"12/16/2024 6 a.m. PST",1225,1162,326,-899
SCL,"12/16/2024 7 a.m. PST",1349,1292,509,-840
SCL,"12/16/2024 8 a.m. PST",1451,1399,621,-830
SCL,"12/16/2024 9 a.m. PST",1462,1425,604,-858
SCL,"12/16/2024 10 a.m. PST",1465,1423,277,-1188
SCL,"12/16/2024 11 a.m. PST",1438,1413,277,-1161
SCL,"12/16/2024 12 p.m. PST",1423,1396,287,-1136
SCL,"12/16/2024 1 p.m. PST",1408,1383,277,-1131
SCL,"12/16/2024 2 p.m. PST",1362,1365,277,-1085
SCL,"12/16/2024 3 p.m. PST",1342,1348,279,-1063
SCL,"12/16/2024 4 p.m. PST",1348,1364,498,-850
SCL,"12/16/2024 5 p.m. PST",1415,1423,582,-833
SCL,"12/16/2024 6 p.m. PST",1459,1466,571,-888
SCL,"12/16/2024 7 p.m. PST",1445,1442,571,-874
SCL,"12/16/2024 8 p.m. PST",1408,1398,572,-836
SCL,"12/16/2024 9 p.m. PST",1333,1359,465,-868
SCL,"12/16/2024 10 p.m. PST",1260,1296,445,-815
SCL,"12/16/2024 11 p.m. PST",1169,1208,275,-894
SCL,"12/17/2024 12 a.m. PST",994,1118,260,-734
SCL,"12/17/2024 1 a.m. PST",1017,1037,133,-884
SCL,"12/17/2024 2 a.m. PST",983,996,126,-857
SCL,"12/17/2024 3 a.m. PST",966,980,130,-836
SCL,"12/17/2024 4 a.m. PST",972,986,131,-841
SCL,"12/17/2024 5 a.m. PST",1006,1030,144,-862
SCL,"12/17/2024 6 a.m. PST",1111,1130,163,-948
SCL,"12/17/2024 7 a.m. PST",1255,1274,475,-780
SCL,"12/17/2024 8 a.m. PST",1367,1391,515,-852
SCL,"12/17/2024 9 a.m. PST",1397,1416,450,-947
SCL,"12/17/2024 10 a.m. PST",1408,1413,215,-1193
SCL,"12/17/2024 11 a.m. PST",1409,1394,300,-1109
SCL,"12/17/2024 12 p.m. PST",1408,1384,345,-1063
SCL,"12/17/2024 1 p.m. PST",1391,1378,300,-1091
SCL,"12/17/2024 2 p.m. PST",1374,1373,302,-1072
SCL,"12/17/2024 3 p.m. PST",1367,1356,310,-1057
SCL,"12/17/2024 4 p.m. PST",1376,1360,362,-1014
SCL,"12/17/2024 5 p.m. PST",1420,1410,547,-873
SCL,"12/17/2024 6 p.m. PST",1441,1442,485,-956
SCL,"12/17/2024 7 p.m. PST",1402,1414,510,-892
SCL,"12/17/2024 8 p.m. PST",1367,1368,531,-836
SCL,"12/17/2024 9 p.m. PST",1314,1321,360,-954
SCL,"12/17/2024 10 p.m. PST",1240,1249,198,-1042
SCL,"12/17/2024 11 p.m. PST",1148,1154,280,-868
SCL,"12/18/2024 12 a.m. PST",963,1067,272,-691
SCL,"12/18/2024 1 a.m. PST",971,997,357,-614
SCL,"12/18/2024 2 a.m. PST",924,942,265,-659
SCL,"12/18/2024 3 a.m. PST",908,918,249,-659
SCL,"12/18/2024 4 a.m. PST",905,917,220,-685
SCL,"12/18/2024 5 a.m. PST",942,952,208,-734
SCL,"12/18/2024 6 a.m. PST",1031,1044,203,-828
SCL,"12/18/2024 7 a.m. PST",1170,1184,251,-919
SCL,"12/18/2024 8 a.m. PST",1269,1307,270,-999
SCL,"12/18/2024 9 a.m. PST",1284,1344,273,-1011
SCL,"12/18/2024 10 a.m. PST",1268,1347,208,-1060
SCL,"12/18/2024 11 a.m. PST",1254,1338,199,-1055
SCL,"12/18/2024 12 p.m. PST",1250,1334,201,-1049
SCL,"12/18/2024 1 p.m. PST",1245,1328,199,-1046
SCL,"12/18/2024 2 p.m. PST",1225,1329,220,-1005
SCL,"12/18/2024 3 p.m. PST",1224,1324,240,-984
SCL,"12/18/2024 4 p.m. PST",1242,1340,415,-827
SCL,"12/18/2024 5 p.m. PST",1286,1397,412,-874
SCL,"12/18/2024 6 p.m. PST",1326,1441,411,-915
SCL,"12/18/2024 7 p.m. PST",1300,1415,411,-889
SCL,"12/18/2024 8 p.m. PST",1276,1388,276,-1000
SCL,"12/18/2024 9 p.m. PST",1247,1351,275,-972
SCL,"12/18/2024 10 p.m. PST",1192,1296,269,-923
SCL,"12/18/2024 11 p.m. PST",1115,1212,272,-843
SCL,"12/19/2024 12 a.m. PST",1028,1119,204,-824
SCL,"12/19/2024 1 a.m. PST",972,986,110,-862
SCL,"12/19/2024 2 a.m. PST",933,947,93,-840
SCL,"12/19/2024 3 a.m. PST",912,930,87,-825
SCL,"12/19/2024 4 a.m. PST",916,930,91,-825
SCL,"12/19/2024 5 a.m. PST",952,960,92,-860
SCL,"12/19/2024 6 a.m. PST",1040,1043,95,-945
SCL,"12/19/2024 7 a.m. PST",1177,1155,189,-988
SCL,"12/19/2024 8 a.m. PST",1286,1231,360,-926
SCL,"12/19/2024 9 a.m. PST",1300,1255,422,-878
SCL,"12/19/2024 10 a.m. PST",1300,1269,464,-836
SCL,"12/19/2024 11 a.m. PST",1277,1263,311,-966
SCL,"12/19/2024 12 p.m. PST",1260,1256,308,-952
SCL,"12/19/2024 1 p.m. PST",1244,1238,306,-938
SCL,"12/19/2024 2 p.m. PST",1224,1221,305,-919
SCL,"12/19/2024 3 p.m. PST",1222,1210,299,-923
SCL,"12/19/2024 4 p.m. PST",1238,1195,420,-818
SCL,"12/19/2024 5 p.m. PST",1286,1250,447,-839
SCL,"12/19/2024 6 p.m. PST",1317,1294,443,-874
SCL,"12/19/2024 7 p.m. PST",1284,1256,574,-710
SCL,"12/19/2024 8 p.m. PST",1247,1226,488,-759
SCL,"12/19/2024 9 p.m. PST",1211,1187,495,-716
SCL,"12/19/2024 10 p.m. PST",1156,1141,415,-741
SCL,"12/19/2024 11 p.m. PST",1077,1072,277,-800
SCL,"12/20/2024 12 a.m. PST",996,1006,146,-850
SCL,"12/20/2024 1 a.m. PST",933,949,257,-676
SCL,"12/20/2024 2 a.m. PST",898,905,237,-661
SCL,"12/20/2024 3 a.m. PST",884,884,205,-679
SCL,"12/20/2024 4 a.m. PST",888,884,204,-684
SCL,"12/20/2024 5 a.m. PST",922,918,244,-678
SCL,"12/20/2024 6 a.m. PST",999,999,513,-486
SCL,"12/20/2024 7 a.m. PST",1132,1109,603,-529
SCL,"12/20/2024 8 a.m. PST",1230,1185,546,-684
SCL,"12/20/2024 9 a.m. PST",1283,1224,532,-751
SCL,"12/20/2024 10 a.m. PST",1303,1253,392,-911
SCL,"12/20/2024 11 a.m. PST",1305,1256,431,-874
SCL,"12/20/2024 12 p.m. PST",1300,1253,449,-851
SCL,"12/20/2024 1 p.m. PST",1290,1234,450,-840
SCL,"12/20/2024 2 p.m. PST",1283,1219,452,-831
SCL,"12/20/2024 3 p.m. PST",1276,1216,465,-811
SCL,"12/20/2024 4 p.m. PST",1271,1223,472,-799
SCL,"12/20/2024 5 p.m. PST",1297,1263,612,-685
SCL,"12/20/2024 6 p.m. PST",1332,1280,650,-682
SCL,"12/20/2024 7 p.m. PST",1300,1235,639,-661
SCL,"12/20/2024 8 p.m. PST",1260,1201,647,-613
SCL,"12/20/2024 9 p.m. PST",1221,1159,638,-583
SCL,"12/20/2024 10 p.m. PST",1176,1125,508,-668
SCL,"12/20/2024 11 p.m. PST",1131,1079,485,-646
SCL,"12/21/2024 12 a.m. PST",1064,1016,485,-579
SCL,"12/21/2024 1 a.m. PST",1010,982,459,-551
SCL,"12/21/2024 2 a.m. PST",979,936,379,-600
SCL,"12/21/2024 3 a.m. PST",956,912,359,-597
SCL,"12/21/2024 4 a.m. PST",938,900,329,-609
SCL,"12/21/2024 5 a.m. PST",933,903,333,-600
SCL,"12/21/2024 6 a.m. PST",972,931,333,-639
SCL,"12/21/2024 7 a.m. PST",1028,982,337,-691
SCL,"12/21/2024 8 a.m. PST",1091,1039,361,-730
SCL,"12/21/2024 9 a.m. PST",1139,1090,344,-795
SCL,"12/21/2024 10 a.m. PST",1184,1138,326,-858
SCL,"12/21/2024 11 a.m. PST",1214,1169,326,-888
SCL,"12/21/2024 12 p.m. PST",1246,1189,322,-924
SCL,"12/21/2024 1 p.m. PST",1259,1192,326,-933
SCL,"12/21/2024 2 p.m. PST",1253,1188,329,-924
SCL,"12/21/2024 3 p.m. PST",1221,1181,329,-892
SCL,"12/21/2024 4 p.m. PST",1210,1177,378,-832
SCL,"12/21/2024 5 p.m. PST",1255,1214,572,-683
SCL,"12/21/2024 6 p.m. PST",1285,1247,560,-725
SCL,"12/21/2024 7 p.m. PST",1270,1228,551,-719
SCL,"12/21/2024 8 p.m. PST",1245,1205,575,-670
SCL,"12/21/2024 9 p.m. PST",1226,1177,664,-562
SCL,"12/21/2024 10 p.m. PST",1184,1151,607,-577
SCL,"12/21/2024 11 p.m. PST",1134,1101,642,-492
SCL,"12/22/2024 12 a.m. PST",1059,1035,568,-491
SCL,"12/22/2024 1 a.m. PST",1028,990,312,-716
SCL,"12/22/2024 2 a.m. PST",983,947,282,-701
SCL,"12/22/2024 3 a.m. PST",947,925,227,-720
SCL,"12/22/2024 4 a.m. PST",955,917,228,-727
SCL,"12/22/2024 5 a.m. PST",961,924,228,-733
SCL,"12/22/2024 6 a.m. PST",987,953,219,-768
SCL,"12/22/2024 7 a.m. PST",1034,1008,267,-767
SCL,"12/22/2024 8 a.m. PST",1096,1066,235,-861
SCL,"12/22/2024 9 a.m. PST",1141,1117,378,-763
SCL,"12/22/2024 10 a.m. PST",1192,1149,429,-763
SCL,"12/22/2024 11 a.m. PST",1223,1171,438,-785
SCL,"12/22/2024 12 p.m. PST",1241,1177,456,-785
SCL,"12/22/2024 1 p.m. PST",1254,1176,503,-751
SCL,"12/22/2024 2 p.m. PST",1254,1181,433,-821
SCL,"12/22/2024 3 p.m. PST",1243,1185,417,-826
SCL,"12/22/2024 4 p.m. PST",1236,1198,451,-785
SCL,"12/22/2024 5 p.m. PST",1271,1246,727,-544
SCL,"12/22/2024 6 p.m. PST",1302,1282,728,-574
SCL,"12/22/2024 7 p.m. PST",1276,1271,615,-661
SCL,"12/22/2024 8 p.m. PST",1216,1240,587,-629
SCL,"12/22/2024 9 p.m. PST",1192,1202,586,-606
SCL,"12/22/2024 10 p.m. PST",1143,1163,442,-701
SCL,"12/22/2024 11 p.m. PST",1079,1085,239,-840
SCL,"12/23/2024 12 a.m. PST",1030,1009,231,-799
SCL,"12/23/2024 1 a.m. PST",993,955,240,-753
SCL,"12/23/2024 2 a.m. PST",941,915,226,-715
SCL,"12/23/2024 3 a.m. PST",945,897,229,-716
SCL,"12/23/2024 4 a.m. PST",950,905,230,-720
SCL,"12/23/2024 5 a.m. PST",991,948,265,-726
SCL,"12/23/2024 6 a.m. PST",1065,1040,394,-671
SCL,"12/23/2024 7 a.m. PST",1140,1152,368,-772
SCL,"12/23/2024 8 a.m. PST",1226,1250,466,-760
SCL,"12/23/2024 9 a.m. PST",1260,1292,411,-849
SCL,"12/23/2024 10 a.m. PST",1255,1323,394,-861
SCL,"12/23/2024 11 a.m. PST",1232,1335,396,-836
SCL,"12/23/2024 12 p.m. PST",1207,1342,393,-814
SCL,"12/23/2024 1 p.m. PST",1203,1340,422,-781
SCL,"12/23/2024 2 p.m. PST",1199,1325,423,-776
SCL,"12/23/2024 3 p.m. PST",1202,1323,460,-742
SCL,"12/23/2024 4 p.m. PST",1221,1330,517,-704
SCL,"12/23/2024 5 p.m. PST",1272,1372,633,-639
SCL,"12/23/2024 6 p.m. PST",1282,1401,668,-614
SCL,"12/23/2024 7 p.m. PST",1244,1357,623,-621
SCL,"12/23/2024 8 p.m. PST",1205,1307,588,-617
SCL,"12/23/2024 9 p.m. PST",1165,1264,485,-680
SCL,"12/23/2024 10 p.m. PST",1113,1209,412,-701
SCL,"12/23/2024 11 p.m. PST",1063,1127,316,-747
SCL,"12/24/2024 12 a.m. PST",990,1043,313,-677
SCL,"12/24/2024 1 a.m. PST",933,942,395,-538
SCL,"12/24/2024 2 a.m. PST",899,909,391,-508
SCL,"12/24/2024 3 a.m. PST",876,892,389,-487
SCL,"12/24/2024 4 a.m. PST",871,895,404,-467
SCL,"12/24/2024 5 a.m. PST",903,931,422,-481
SCL,"12/24/2024 6 a.m. PST",974,1027,498,-476
SCL,"12/24/2024 7 a.m. PST",1065,1161,497,-568
SCL,"12/24/2024 8 a.m. PST",1136,1271,569,-567
SCL,"12/24/2024 9 a.m. PST",1175,1318,664,-511
SCL,"12/24/2024 10 a.m. PST",1205,1322,651,-554
SCL,"12/24/2024 11 a.m. PST",1228,1314,590,-638
SCL,"12/24/2024 12 p.m. PST",1224,1312,590,-634
SCL,"12/24/2024 1 p.m. PST",1182,1302,530,-652
SCL,"12/24/2024 2 p.m. PST",1150,1297,456,-694
SCL,"12/24/2024 3 p.m. PST",1143,1292,553,-590
SCL,"12/24/2024 4 p.m. PST",1160,1288,515,-645
SCL,"12/24/2024 5 p.m. PST",1208,1327,568,-640
SCL,"12/24/2024 6 p.m. PST",1236,1347,601,-635
SCL,"12/24/2024 7 p.m. PST",1191,1313,606,-585
SCL,"12/24/2024 8 p.m. PST",1148,1264,627,-521
SCL,"12/24/2024 9 p.m. PST",1130,1231,572,-558
SCL,"12/24/2024 10 p.m. PST",1100,1190,514,-586
SCL,"12/24/2024 11 p.m. PST",1055,1122,566,-489
SCL,"12/25/2024 12 a.m. PST",1011,1041,515,-496
SCL,"12/25/2024 1 a.m. PST",969,967,565,-404
SCL,"12/25/2024 2 a.m. PST",940,940,558,-382
SCL,"12/25/2024 3 a.m. PST",925,925,507,-418
SCL,"12/25/2024 4 a.m. PST",924,926,496,-428
SCL,"12/25/2024 5 a.m. PST",940,955,606,-334
SCL,"12/25/2024 6 a.m. PST",998,1025,660,-338
SCL,"12/25/2024 7 a.m. PST",1061,1130,813,-248
SCL,"12/25/2024 8 a.m. PST",1108,1215,797,-311
SCL,"12/25/2024 9 a.m. PST",1151,1236,716,-435
SCL,"12/25/2024 10 a.m. PST",1190,1224,578,-612
SCL,"12/25/2024 11 a.m. PST",1211,1214,582,-629
SCL,"12/25/2024 12 p.m. PST",1226,1203,680,-546
SCL,"12/25/2024 1 p.m. PST",1246,1194,597,-649
SCL,"12/25/2024 2 p.m. PST",1257,1194,646,-611
SCL,"12/25/2024 3 p.m. PST",1251,1173,663,-588
SCL,"12/25/2024 4 p.m. PST",1247,1190,754,-493
SCL,"12/25/2024 5 p.m. PST",1267,1240,853,-414
SCL,"12/25/2024 6 p.m. PST",1264,1249,799,-465
SCL,"12/25/2024 7 p.m. PST",1216,1223,745,-471
SCL,"12/25/2024 8 p.m. PST",1186,1195,757,-429
SCL,"12/25/2024 9 p.m. PST",1175,1178,647,-528
SCL,"12/25/2024 10 p.m. PST",1144,1142,641,-503
SCL,"12/25/2024 11 p.m. PST",1102,1089,517,-585
SCL,"12/26/2024 12 a.m. PST",1054,1031,463,-591
SCL,"12/26/2024 1 a.m. PST",1003,1000,501,-502
SCL,"12/26/2024 2 a.m. PST",960,971,346,-614
SCL,"12/26/2024 3 a.m. PST",938,951,340,-598
SCL,"12/26/2024 4 a.m. PST",938,953,339,-599
SCL,"12/26/2024 5 a.m. PST",972,992,416,-556
SCL,"12/26/2024 6 a.m. PST",1050,1077,442,-608
SCL,"12/26/2024 7 a.m. PST",1160,1190,406,-754
SCL,"12/26/2024 8 a.m. PST",1220,1265,335,-885
SCL,"12/26/2024 9 a.m. PST",1258,1299,290,-968
SCL,"12/26/2024 10 a.m. PST",1282,1309,265,-1017
SCL,"12/26/2024 11 a.m. PST",1298,1310,290,-1008
SCL,"12/26/2024 12 p.m. PST",1306,1292,321,-985
SCL,"12/26/2024 1 p.m. PST",1263,1284,298,-965
SCL,"12/26/2024 2 p.m. PST",1222,1276,294,-928
SCL,"12/26/2024 3 p.m. PST",1200,1272,392,-808
SCL,"12/26/2024 4 p.m. PST",1214,1284,506,-708
SCL,"12/26/2024 5 p.m. PST",1283,1340,712,-571
SCL,"12/26/2024 6 p.m. PST",1327,1371,772,-555
SCL,"12/26/2024 7 p.m. PST",1283,1344,674,-609
SCL,"12/26/2024 8 p.m. PST",1246,1308,683,-563
SCL,"12/26/2024 9 p.m. PST",1212,1279,582,-630
SCL,"12/26/2024 10 p.m. PST",1157,1230,599,-558
SCL,"12/26/2024 11 p.m. PST",1090,1163,566,-524
SCL,"12/27/2024 12 a.m. PST",1021,1102,471,-550
SCL,"12/27/2024 1 a.m. PST",965,968,394,-571
SCL,"12/27/2024 2 a.m. PST",924,940,389,-535
SCL,"12/27/2024 3 a.m. PST",910,924,355,-555
SCL,"12/27/2024 4 a.m. PST",907,933,334,-573
SCL,"12/27/2024 5 a.m. PST",951,983,422,-529
SCL,"12/27/2024 6 a.m. PST",1031,1080,655,-376
SCL,"12/27/2024 7 a.m. PST",1126,1197,587,-539
SCL,"12/27/2024 8 a.m. PST",1199,1277,664,-535
SCL,"12/27/2024 9 a.m. PST",1232,1319,545,-687
SCL,"12/27/2024 10 a.m. PST",1262,1345,500,-762
SCL,"12/27/2024 11 a.m. PST",1278,1360,416,-862
SCL,"12/27/2024 12 p.m. PST",1284,1356,480,-804
SCL,"12/27/2024 1 p.m. PST",1291,1349,463,-828
SCL,"12/27/2024 2 p.m. PST",1292,1339,495,-797
SCL,"12/27/2024 3 p.m. PST",1294,1336,499,-795
SCL,"12/27/2024 4 p.m. PST",1292,1335,516,-776
SCL,"12/27/2024 5 p.m. PST",1321,1358,708,-613
SCL,"12/27/2024 6 p.m. PST",1334,1390,729,-605
SCL,"12/27/2024 7 p.m. PST",1270,1339,847,-423
SCL,"12/27/2024 8 p.m. PST",1231,1291,831,-400
SCL,"12/27/2024 9 p.m. PST",1193,1253,549,-644
SCL,"12/27/2024 10 p.m. PST",1148,1214,443,-705
SCL,"12/27/2024 11 p.m. PST",1093,1163,503,-590
SCL,"12/28/2024 12 a.m. PST",1032,1105,487,-545
SCL,"12/28/2024 1 a.m. PST",981,985,482,-499
SCL,"12/28/2024 2 a.m. PST",936,943,325,-611
SCL,"12/28/2024 3 a.m. PST",909,918,305,-604
SCL,"12/28/2024 4 a.m. PST",902,911,308,-594
SCL,"12/28/2024 5 a.m. PST",912,927,393,-519
SCL,"12/28/2024 6 a.m. PST",951,968,413,-538
SCL,"12/28/2024 7 a.m. PST",1002,1035,450,-552
SCL,"12/28/2024 8 a.m. PST",1051,1112,438,-613
SCL,"12/28/2024 9 a.m. PST",1100,1173,357,-743
SCL,"12/28/2024 10 a.m. PST",1144,1220,357,-787
SCL,"12/28/2024 11 a.m. PST",1164,1243,352,-812
SCL,"12/28/2024 12 p.m. PST",1178,1255,339,-839
SCL,"12/28/2024 1 p.m. PST",1177,1254,314,-863
SCL,"12/28/2024 2 p.m. PST",1153,1248,326,-827
SCL,"12/28/2024 3 p.m. PST",1154,1247,332,-822
SCL,"12/28/2024 4 p.m. PST",1161,1248,414,-747
SCL,"12/28/2024 5 p.m. PST",1204,1285,667,-537
SCL,"12/28/2024 6 p.m. PST",1231,1313,727,-504
SCL,"12/28/2024 7 p.m. PST",1223,1299,741,-482
SCL,"12/28/2024 8 p.m. PST",1195,1268,717,-478
SCL,"12/28/2024 9 p.m. PST",1168,1238,685,-483
SCL,"12/28/2024 10 p.m. PST",1128,1200,544,-584
SCL,"12/28/2024 11 p.m. PST",1068,1144,569,-499
SCL,"12/29/2024 12 a.m. PST",1006,1084,530,-476
SCL,"12/29/2024 1 a.m. PST",956,967,317,-639
SCL,"12/29/2024 2 a.m. PST",912,926,255,-657
SCL,"12/29/2024 3 a.m. PST",896,906,262,-634
SCL,"12/29/2024 4 a.m. PST",887,902,308,-579
SCL,"12/29/2024 5 a.m. PST",891,919,322,-569
SCL,"12/29/2024 6 a.m. PST",921,958,379,-542
SCL,"12/29/2024 7 a.m. PST",967,1022,414,-553
SCL,"12/29/2024 8 a.m. PST",1012,1094,472,-540
SCL,"12/29/2024 9 a.m. PST",1060,1153,421,-639
SCL,"12/29/2024 10 a.m. PST",1099,1189,393,-706
SCL,"12/29/2024 11 a.m. PST",1149,1213,393,-756
SCL,"12/29/2024 12 p.m. PST",1171,1223,314,-857
SCL,"12/29/2024 1 p.m. PST",1183,1231,317,-866
SCL,"12/29/2024 2 p.m. PST",1190,1232,317,-873
SCL,"12/29/2024 3 p.m. PST",1203,1236,316,-887
SCL,"12/29/2024 4 p.m. PST",1206,1254,465,-741
SCL,"12/29/2024 5 p.m. PST",1241,1302,689,-552
SCL,"12/29/2024 6 p.m. PST",1276,1350,750,-526
SCL,"12/29/2024 7 p.m. PST",1270,1346,694,-576
SCL,"12/29/2024 8 p.m. PST",1257,1312,698,-559
SCL,"12/29/2024 9 p.m. PST",1234,1279,680,-554
SCL,"12/29/2024 10 p.m. PST",1184,1230,613,-571
SCL,"12/29/2024 11 p.m. PST",1120,1152,512,-608
SCL,"12/30/2024 12 a.m. PST",1053,1077,309,-744
SCL,"12/30/2024 1 a.m. PST",1002,1004,325,-677
SCL,"12/30/2024 2 a.m. PST",971,980,266,-705
SCL,"12/30/2024 3 a.m. PST",961,967,264,-697
SCL,"12/30/2024 4 a.m. PST",977,979,313,-664
SCL,"12/30/2024 5 a.m. PST",1017,1027,325,-692
SCL,"12/30/2024 6 a.m. PST",1106,1119,466,-640
SCL,"12/30/2024 7 a.m. PST",1220,1223,476,-744
SCL,"12/30/2024 8 a.m. PST",1298,1289,596,-702
SCL,"12/30/2024 9 a.m. PST",1336,1313,579,-757
SCL,"12/30/2024 10 a.m. PST",1355,1323,508,-847
SCL,"12/30/2024 11 a.m. PST",1350,1327,509,-841
SCL,"12/30/2024 12 p.m. PST",1360,1314,495,-865
SCL,"12/30/2024 1 p.m. PST",1350,1306,491,-859
SCL,"12/30/2024 2 p.m. PST",1345,1287,486,-859
SCL,"12/30/2024 3 p.m. PST",1333,1287,486,-847
SCL,"12/30/2024 4 p.m. PST",1346,1297,564,-782
SCL,"12/30/2024 5 p.m. PST",1371,1352,646,-725
SCL,"12/30/2024 6 p.m. PST",1389,1389,669,-720
SCL,"12/30/2024 7 p.m. PST",1339,1359,655,-684
SCL,"12/30/2024 8 p.m. PST",1312,1313,540,-772
SCL,"12/30/2024 9 p.m. PST",1273,1273,458,-815
SCL,"12/30/2024 10 p.m. PST",1219,1220,416,-803
SCL,"12/30/2024 11 p.m. PST",1144,1147,432,-712
SCL,"12/31/2024 12 a.m. PST",1076,1079,325,-751
SCL,"12/31/2024 1 a.m. PST",1011,1016,352,-659
SCL,"12/31/2024 2 a.m. PST",975,989,343,-632
SCL,"12/31/2024 3 a.m. PST",957,974,358,-599
SCL,"12/31/2024 4 a.m. PST",957,982,376,-581
SCL,"12/31/2024 5 a.m. PST",996,1023,536,-460
SCL,"12/31/2024 6 a.m. PST",1069,1112,523,-546
SCL,"12/31/2024 7 a.m. PST",1188,1242,533,-655
SCL,"12/31/2024 8 a.m. PST",1277,1345,708,-569
SCL,"12/31/2024 9 a.m. PST",1314,1375,602,-712
SCL,"12/31/2024 10 a.m. PST",1328,1369,502,-826
SCL,"12/31/2024 11 a.m. PST",1345,1349,504,-841
SCL,"12/31/2024 12 p.m. PST",1329,1329,477,-852
SCL,"12/31/2024 1 p.m. PST",1318,1320,379,-939
SCL,"12/31/2024 2 p.m. PST",1304,1303,385,-919
SCL,"12/31/2024 3 p.m. PST",1303,1303,384,-919
SCL,"12/31/2024 4 p.m. PST",1311,1319,442,-869
SCL,"12/31/2024 5 p.m. PST",1380,1381,724,-656
SCL,"12/31/2024 6 p.m. PST",1407,1441,733,-674
SCL,"12/31/2024 7 p.m. PST",1362,1417,725,-637
SCL,"12/31/2024 8 p.m. PST",1292,1383,662,-630
SCL,"12/31/2024 9 p.m. PST",1232,1335,593,-639
SCL,"12/31/2024 10 p.m. PST",1178,1275,536,-642
SCL,"12/31/2024 11 p.m. PST",1119,1205,529,-590