"BA Code","Timestamp (Hour Ending)","Demand (MWh)","Demand Forecast (MWh)","Net Generation (MWh)","Total Interchange (MWh)"
SCL,"2/1/2025 12 a.m. PST",1198,1189,670,-528
SCL,"2/1/2025 1 a.m. PST",1147,1108,655,-492
SCL,"2/1/2025 2 a.m. PST",1084,1072,626,-458
SCL,"2/1/2025 3 a.m. PST",1068,1057,431,-637
SCL,"2/1/2025 4 a.m. PST",1076,1055,430,-646
SCL,"2/1/2025 5 a.m. PST",1121,1068,438,-683
SCL,"2/1/2025 6 a.m. PST",1176,1106,619,-557
SCL,"2/1/2025 7 a.m. PST",1245,1170,685,-560
SCL,"2/1/2025 8 a.m. PST",1322,1240,699,-623
SCL,"2/1/2025 9 a.m. PST",1391,1304,638,-753
SCL,"2/1/2025 10 a.m. PST",1449,1338,606,-843
SCL,"2/1/2025 11 a.m. PST",1455,1350,598,-857
SCL,"2/1/2025 12 p.m. PST",1459,1362,699,-760
SCL,"2/1/2025 1 p.m. PST",1470,1363,704,-766
SCL,"2/1/2025 2 p.m. PST",1440,1349,722,-718
SCL,"2/1/2025 3 p.m. PST",1423,1347,638,-785
SCL,"2/1/2025 4 p.m. PST",1409,1349,583,-826
SCL,"2/1/2025 5 p.m. PST",1426,1380,799,-627
SCL,"2/1/2025 6 p.m. PST",1499,1426,811,-688
SCL,"2/1/2025 7 p.m. PST",1528,1425,800,-728
SCL,"2/1/2025 8 p.m. PST",1497,1393,770,-727
SCL,"2/1/2025 9 p.m. PST",1459,1366,780,-679
SCL,"2/1/2025 10 p.m. PST",1418,1312,711,-707
SCL,"2/1/2025 11 p.m. PST",1348,1248,729,-619
SCL,"2/2/2025 12 a.m. PST",1285,1193,723,-562
SCL,"2/2/2025 1 a.m. PST",1225,1197,325,-900
SCL,"2/2/2025 2 a.m. PST",1199,1162,288,-911
SCL,"2/2/2025 3 a.m. PST",1175,1148,283,-892
SCL,"2/2/2025 4 a.m. PST",1170,1142,283,-887
SCL,"2/2/2025 5 a.m. PST",1190,1144,283,-907
SCL,"2/2/2025 6 a.m. PST",1222,1168,349,-873
SCL,"2/2/2025 7 a.m. PST",1257,1214,453,-804
SCL,"2/2/2025 8 a.m. PST",1336,1266,473,-863
SCL,"2/2/2025 9 a.m. PST",1419,1312,452,-967
SCL,"2/2/2025 10 a.m. PST",1487,1350,509,-978
SCL,"2/2/2025 11 a.m. PST",1530,1354,593,-937
SCL,"2/2/2025 12 p.m. PST",1548,1342,614,-934
SCL,"2/2/2025 1 p.m. PST",1535,1341,478,-1057
SCL,"2/2/2025 2 p.m. PST",1513,1327,393,-1120
SCL,"2/2/2025 3 p.m. PST",1457,1320,387,-1070
SCL,"2/2/2025 4 p.m. PST",1478,1341,372,-1106
SCL,"2/2/2025 5 p.m. PST",1534,1374,636,-898
SCL,"2/2/2025 6 p.m. PST",1616,1441,681,-935
SCL,"2/2/2025 7 p.m. PST",1647,1461,602,-1045
SCL,"2/2/2025 8 p.m. PST",1620,1439,602,-1018
SCL,"2/2/2025 9 p.m. PST",1575,1415,594,-981
SCL,"2/2/2025 10 p.m. PST",1511,1357,591,-920
SCL,"2/2/2025 11 p.m. PST",1407,1275,459,-948
SCL,"2/3/2025 12 a.m. PST",1314,1196,428,-886
SCL,"2/3/2025 1 a.m. PST",1272,1224,434,-838
SCL,"2/3/2025 2 a.m. PST",1229,1180,317,-912
SCL,"2/3/2025 3 a.m. PST",1226,1174,313,-913
SCL,"2/3/2025 4 a.m. PST",1242,1190,311,-931
SCL,"2/3/2025 5 a.m. PST",1287,1240,349,-938
SCL,"2/3/2025 6 a.m. PST",1390,1347,532,-858
SCL,"2/3/2025 7 a.m. PST",1534,1498,696,-838
SCL,"2/3/2025 8 a.m. PST",1648,1621,724,-924
SCL,"2/3/2025 9 a.m. PST",1693,1652,642,-1051
SCL,"2/3/2025 10 a.m. PST",1713,1631,620,-1093
SCL,"2/3/2025 11 a.m. PST",1684,1597,610,-1074
SCL,"2/3/2025 12 p.m. PST",1641,1557,503,-1138
SCL,"2/3/2025 1 p.m. PST",1620,1531,564,-1056
SCL,"2/3/2025 2 p.m. PST",1582,1505,575,-1007
SCL,"2/3/2025 3 p.m. PST",1561,1480,545,-1016
SCL,"2/3/2025 4 p.m. PST",1572,1478,645,-927
SCL,"2/3/2025 5 p.m. PST",1606,1515,834,-772
SCL,"2/3/2025 6 p.m. PST",1663,1569,816,-847
SCL,"2/3/2025 7 p.m. PST",1659,1572,828,-831
SCL,"2/3/2025 8 p.m. PST",1627,1536,855,-772
SCL,"2/3/2025 9 p.m. PST",1574,1487,803,-771
SCL,"2/3/2025 10 p.m. PST",1496,1419,641,-855
SCL,"2/3/2025 11 p.m. PST",1390,1324,575,-815
SCL,"2/4/2025 12 a.m. PST",1296,1238,444,-852
SCL,"2/4/2025 1 a.m. PST",1250,1203,269,-981
SCL,"2/4/2025 2 a.m. PST",1213,1169,260,-953
SCL,"2/4/2025 3 a.m. PST",1212,1161,248,-964
SCL,"2/4/2025 4 a.m. PST",1227,1175,275,-952
SCL,"2/4/2025 5 a.m. PST",1258,1224,310,-948
SCL,"2/4/2025 6 a.m. PST",1383,1336,534,-849
SCL,"2/4/2025 7 a.m. PST",1550,1498,585,-965
SCL,"2/4/2025 8 a.m. PST",1665,1631,575,-1090
SCL,"2/4/2025 9 a.m. PST",1677,1651,575,-1102
SCL,"2/4/2025 10 a.m. PST",1663,1628,390,-1273
SCL,"2/4/2025 11 a.m. PST",1615,1588,393,-1222
SCL,"2/4/2025 12 p.m. PST",1562,1559,325,-1237
SCL,"2/4/2025 1 p.m. PST",1497,1534,311,-1186
SCL,"2/4/2025 2 p.m. PST",1455,1509,306,-1149
SCL,"2/4/2025 3 p.m. PST",1454,1482,211,-1243
SCL,"2/4/2025 4 p.m. PST",1464,1495,205,-1259
SCL,"2/4/2025 5 p.m. PST",1533,1528,461,-1072
SCL,"2/4/2025 6 p.m. PST",1616,1598,544,-1072
SCL,"2/4/2025 7 p.m. PST",1622,1601,591,-1031
SCL,"2/4/2025 8 p.m. PST",1583,1570,547,-1036
SCL,"2/4/2025 9 p.m. PST",1546,1529,521,-1025
SCL,"2/4/2025 10 p.m. PST",1491,1459,508,-983
SCL,"2/4/2025 11 p.m. PST",1398,1360,336,-1062
SCL,"2/5/2025 12 a.m. PST",1314,1269,327,-987
SCL,"2/5/2025 1 a.m. PST",1260,1204,383,-877
SCL,"2/5/2025 2 a.m. PST",1208,1188,330,-878
SCL,"2/5/2025 3 a.m. PST",1180,1181,328,-852
SCL,"2/5/2025 4 a.m. PST",1201,1194,332,-869
SCL,"2/5/2025 5 a.m. PST",1252,1237,475,-777
SCL,"2/5/2025 6 a.m. PST",1352,1339,610,-742
SCL,"2/5/2025 7 a.m. PST",1487,1491,609,-878
SCL,"2/5/2025 8 a.m. PST",1605,1604,646,-959
SCL,"2/5/2025 9 a.m. PST",1652,1627,637,-1015
SCL,"2/5/2025 10 a.m. PST",1655,1599,583,-1072
SCL,"2/5/2025 11 a.m. PST",1633,1563,435,-1198
SCL,"2/5/2025 12 p.m. PST",1599,1529,415,-1184
SCL,"2/5/2025 1 p.m. PST",1595,1508,398,-1197
SCL,"2/5/2025 2 p.m. PST",1607,1484,376,-1231
SCL,"2/5/2025 3 p.m. PST",1567,1458,252,-1315
SCL,"2/5/2025 4 p.m. PST",1546,1474,296,-1250
SCL,"2/5/2025 5 p.m. PST",1575,1513,590,-985
SCL,"2/5/2025 6 p.m. PST",1624,1573,661,-963
SCL,"2/5/2025 7 p.m. PST",1603,1569,645,-958
SCL,"2/5/2025 8 p.m. PST",1568,1539,577,-991
SCL,"2/5/2025 9 p.m. PST",1516,1494,491,-1025
SCL,"2/5/2025 10 p.m. PST",1438,1426,492,-946
SCL,"2/5/2025 11 p.m. PST",1341,1330,341,-1000
SCL,"2/6/2025 12 a.m. PST",1256,1243,291,-965
SCL,"2/6/2025 1 a.m. PST",1206,1202,209,-997
SCL,"2/6/2025 2 a.m. PST",1177,1176,209,-968
SCL,"2/6/2025 3 a.m. PST",1163,1166,187,-976
SCL,"2/6/2025 4 a.m. PST",1180,1175,244,-936
SCL,"2/6/2025 5 a.m. PST",1229,1219,340,-889
SCL,"2/6/2025 6 a.m. PST",1332,1325,539,-793
SCL,"2/6/2025 7 a.m. PST",1458,1478,551,-907
SCL,"2/6/2025 8 a.m. PST",1569,1599,639,-930
SCL,"2/6/2025 9 a.m. PST",1622,1629,651,-971
SCL,"2/6/2025 10 a.m. PST",1631,1611,598,-1033
SCL,"2/6/2025 11 a.m. PST",1589,1579,428,-1161
SCL,"2/6/2025 12 p.m. PST",1575,1553,425,-1150
SCL,"2/6/2025 1 p.m. PST",1543,1533,433,-1110
SCL,"2/6/2025 2 p.m. PST",1504,1509,420,-1084
SCL,"2/6/2025 3 p.m. PST",1466,1484,391,-1075
SCL,"2/6/2025 4 p.m. PST",1498,1491,395,-1103
SCL,"2/6/2025 5 p.m. PST",1537,1532,545,-992
SCL,"2/6/2025 6 p.m. PST",1597,1590,538,-1059
SCL,"2/6/2025 7 p.m. PST",1590,1592,541,-1049
SCL,"2/6/2025 8 p.m. PST",1561,1561,548,-1013
SCL,"2/6/2025 9 p.m. PST",1518,1522,486,-1032
SCL,"2/6/2025 10 p.m. PST",1450,1459,353,-1097
SCL,"2/6/2025 11 p.m. PST",1365,1365,205,-1160
SCL,"2/7/2025 12 a.m. PST",1290,1282,197,-1093
SCL,"2/7/2025 1 a.m. PST",1240,1255,199,-1041
SCL,"2/7/2025 2 a.m. PST",1216,1218,199,-1017
SCL,"2/7/2025 3 a.m. PST",1207,1211,202,-1005
SCL,"2/7/2025 4 a.m. PST",1218,1221,200,-1018
SCL,"2/7/2025 5 a.m. PST",1265,1260,260,-1005
SCL,"2/7/2025 6 a.m. PST",1378,1363,540,-838
SCL,"2/7/2025 7 a.m. PST",1534,1509,544,-990
SCL,"2/7/2025 8 a.m. PST",1658,1624,638,-1020
SCL,"2/7/2025 9 a.m. PST",1690,1647,636,-1054
SCL,"2/7/2025 10 a.m. PST",1665,1624,581,-1084
SCL,"2/7/2025 11 a.m. PST",1616,1587,421,-1195
SCL,"2/7/2025 12 p.m. PST",1575,1548,422,-1153
SCL,"2/7/2025 1 p.m. PST",1556,1516,286,-1270
SCL,"2/7/2025 2 p.m. PST",1565,1488,282,-1283
SCL,"2/7/2025 3 p.m. PST",1540,1474,302,-1238
SCL,"2/7/2025 4 p.m. PST",1543,1455,337,-1206
SCL,"2/7/2025 5 p.m. PST",1585,1488,545,-1040
SCL,"2/7/2025 6 p.m. PST",1612,1536,580,-1032
SCL,"2/7/2025 7 p.m. PST",1599,1527,577,-1022
SCL,"2/7/2025 8 p.m. PST",1551,1485,580,-971
SCL,"2/7/2025 9 p.m. PST",1497,1449,530,-967
SCL,"2/7/2025 10 p.m. PST",1452,1392,271,-1181
SCL,"2/7/2025 11 p.m. PST",1364,1322,262,-1102
SCL,"2/8/2025 12 a.m. PST",1290,1257,280,-1010
SCL,"2/8/2025 1 a.m. PST",1250,1200,268,-982
SCL,"2/8/2025 2 a.m. PST",1197,1164,256,-941
SCL,"2/8/2025 3 a.m. PST",1178,1147,270,-908
SCL,"2/8/2025 4 a.m. PST",1181,1147,270,-911
SCL,"2/8/2025 5 a.m. PST",1201,1166,271,-930
SCL,"2/8/2025 6 a.m. PST",1242,1215,281,-961
SCL,"2/8/2025 7 a.m. PST",1304,1285,439,-865
SCL,"2/8/2025 8 a.m. PST",1374,1367,630,-744
SCL,"2/8/2025 9 a.m. PST",1449,1432,637,-812
SCL,"2/8/2025 10 a.m. PST",1480,1465,628,-852
SCL,"2/8/2025 11 a.m. PST",1511,1464,398,-1113
SCL,"2/8/2025 12 p.m. PST",1488,1455,291,-1197
SCL,"2/8/2025 1 p.m. PST",1480,1448,293,-1187
SCL,"2/8/2025 2 p.m. PST",1445,1420,290,-1155
SCL,"2/8/2025 3 p.m. PST",1435,1412,286,-1149
SCL,"2/8/2025 4 p.m. PST",1430,1402,421,-1009
SCL,"2/8/2025 5 p.m. PST",1424,1435,557,-867
SCL,"2/8/2025 6 p.m. PST",1494,1487,648,-846
SCL,"2/8/2025 7 p.m. PST",1475,1503,657,-818
SCL,"2/8/2025 8 p.m. PST",1475,1475,664,-811
SCL,"2/8/2025 9 p.m. PST",1453,1439,661,-792
SCL,"2/8/2025 10 p.m. PST",1411,1380,564,-847
SCL,"2/8/2025 11 p.m. PST",1341,1315,479,-862
SCL,"2/9/2025 12 a.m. PST",1270,1251,353,-917
SCL,"2/9/2025 1 a.m. PST",1185,1185,210,-975
SCL,"2/9/2025 2 a.m. PST",1143,1154,188,-955
SCL,"2/9/2025 3 a.m. PST",1135,1138,172,-963
SCL,"2/9/2025 4 a.m. PST",1157,1135,166,-991
SCL,"2/9/2025 5 a.m. PST",1176,1143,346,-830
SCL,"2/9/2025 6 a.m. PST",1203,1174,375,-828
SCL,"2/9/2025 7 a.m. PST",1272,1232,440,-832
SCL,"2/9/2025 8 a.m. PST",1310,1293,525,-785
SCL,"2/9/2025 9 a.m. PST",1378,1343,525,-853
SCL,"2/9/2025 10 a.m. PST",1394,1385,518,-876
SCL,"2/9/2025 11 a.m. PST",1399,1395,369,-1030
SCL,"2/9/2025 12 p.m. PST",1408,1385,333,-1075
SCL,"2/9/2025 1 p.m. PST",1417,1379,337,-1080
SCL,"2/9/2025 2 p.m. PST",1426,1366,337,-1089
SCL,"2/9/2025 3 p.m. PST",1428,1356,343,-1085
SCL,"2/9/2025 4 p.m. PST",1419,1367,495,-924
SCL,"2/9/2025 5 p.m. PST",1418,1398,547,-871
SCL,"2/9/2025 6 p.m. PST",1470,1470,633,-837
SCL,"2/9/2025 7 p.m. PST",1496,1498,636,-860
SCL,"2/9/2025 8 p.m. PST",1486,1494,631,-855
SCL,"2/9/2025 9 p.m. PST",1495,1467,607,-888
SCL,"2/9/2025 10 p.m. PST",1442,1408,612,-830
SCL,"2/9/2025 11 p.m. PST",1356,1332,528,-828
SCL,"2/10/2025 12 a.m. PST",1276,1246,408,-868
SCL,"2/10/2025 1 a.m. PST",1239,1194,213,-1026
SCL,"2/10/2025 2 a.m. PST",1226,1164,190,-1036
SCL,"2/10/2025 3 a.m. PST",1213,1162,186,-1027
SCL,"2/10/2025 4 a.m. PST",1228,1181,197,-1031
SCL,"2/10/2025 5 a.m. PST",1276,1232,227,-1049
SCL,"2/10/2025 6 a.m. PST",1382,1340,461,-921
SCL,"2/10/2025 7 a.m. PST",1534,1492,666,-868
SCL,"2/10/2025 8 a.m. PST",1641,1609,806,-835
SCL,"2/10/2025 9 a.m. PST",1652,1638,812,-840
SCL,"2/10/2025 10 a.m. PST",1651,1609,707,-944
SCL,"2/10/2025 11 a.m. PST",1645,1574,470,-1175
SCL,"2/10/2025 12 p.m. PST",1627,1533,264,-1363
SCL,"2/10/2025 1 p.m. PST",1604,1506,262,-1342
SCL,"2/10/2025 2 p.m. PST",1542,1471,262,-1280
SCL,"2/10/2025 3 p.m. PST",1514,1434,268,-1246
SCL,"2/10/2025 4 p.m. PST",1488,1443,436,-1052
SCL,"2/10/2025 5 p.m. PST",1555,1478,616,-939
SCL,"2/10/2025 6 p.m. PST",1657,1540,693,-964
SCL,"2/10/2025 7 p.m. PST",1708,1558,714,-994
SCL,"2/10/2025 8 p.m. PST",1667,1523,674,-993
SCL,"2/10/2025 9 p.m. PST",1657,1480,537,-1120
SCL,"2/10/2025 10 p.m. PST",1580,1405,514,-1066
SCL,"2/10/2025 11 p.m. PST",1478,1317,358,-1120
SCL,"2/11/2025 12 a.m. PST",1393,1232,330,-1063
SCL,"2/11/2025 1 a.m. PST",1344,1304,315,-1029
SCL,"2/11/2025 2 a.m. PST",1316,1269,291,-1025
SCL,"2/11/2025 3 a.m. PST",1312,1264,207,-1105
SCL,"2/11/2025 4 a.m. PST",1335,1272,236,-1099
SCL,"2/11/2025 5 a.m. PST",1395,1303,347,-1048
SCL,"2/11/2025 6 a.m. PST",1517,1398,665,-852
SCL,"2/11/2025 7 a.m. PST",1681,1549,827,-854
SCL,"2/11/2025 8 a.m. PST",1816,1667,832,-984
SCL,"2/11/2025 9 a.m. PST",1816,1675,826,-990
SCL,"2/11/2025 10 a.m. PST",1730,1638,607,-1123
SCL,"2/11/2025 11 a.m. PST",1667,1588,409,-1258
SCL,"2/11/2025 12 p.m. PST",1636,1550,360,-1276
SCL,"2/11/2025 1 p.m. PST",1597,1518,354,-1243
SCL,"2/11/2025 2 p.m. PST",1551,1488,355,-1196
SCL,"2/11/2025 3 p.m. PST",1525,1456,389,-1136
SCL,"2/11/2025 4 p.m. PST",1521,1451,517,-1004
SCL,"2/11/2025 5 p.m. PST",1569,1491,666,-903
SCL,"2/11/2025 6 p.m. PST",1616,1563,648,-968
SCL,"2/11/2025 7 p.m. PST",1667,1585,655,-1012
SCL,"2/11/2025 8 p.m. PST",1657,1558,613,-1044
SCL,"2/11/2025 9 p.m. PST",1630,1519,616,-1014
SCL,"2/11/2025 10 p.m. PST",1569,1450,562,-1007
SCL,"2/11/2025 11 p.m. PST",1469,1353,478,-991
SCL,"2/12/2025 12 a.m. PST",1316,1264,463,-853
SCL,"2/12/2025 1 a.m. PST",1382,1347,311,-1071
SCL,"2/12/2025 2 a.m. PST",1357,1308,286,-1071
SCL,"2/12/2025 3 a.m. PST",1358,1304,336,-1022
SCL,"2/12/2025 4 a.m. PST",1368,1313,368,-1000
SCL,"2/12/2025 5 a.m. PST",1383,1341,364,-1019
SCL,"2/12/2025 6 a.m. PST",1494,1431,631,-863
SCL,"2/12/2025 7 a.m. PST",1660,1574,849,-811
SCL,"2/12/2025 8 a.m. PST",1773,1675,854,-919
SCL,"2/12/2025 9 a.m. PST",1758,1688,885,-873
SCL,"2/12/2025 10 a.m. PST",1695,1651,770,-925
SCL,"2/12/2025 11 a.m. PST",1617,1594,651,-966
SCL,"2/12/2025 12 p.m. PST",1553,1540,213,-1340
SCL,"2/12/2025 1 p.m. PST",1501,1500,207,-1294
SCL,"2/12/2025 2 p.m. PST",1454,1460,217,-1237
SCL,"2/12/2025 3 p.m. PST",1409,1428,191,-1218
SCL,"2/12/2025 4 p.m. PST",1407,1416,489,-918
SCL,"2/12/2025 5 p.m. PST",1445,1456,549,-896
SCL,"2/12/2025 6 p.m. PST",1536,1542,553,-983
SCL,"2/12/2025 7 p.m. PST",1578,1573,642,-936
SCL,"2/12/2025 8 p.m. PST",1573,1550,638,-935
SCL,"2/12/2025 9 p.m. PST",1558,1519,541,-1017
SCL,"2/12/2025 10 p.m. PST",1497,1452,481,-1016
SCL,"2/12/2025 11 p.m. PST",1404,1363,485,-919
SCL,"2/13/2025 12 a.m. PST",1314,1276,314,-1000
SCL,"2/13/2025 1 a.m. PST",1268,1281,324,-944
SCL,"2/13/2025 2 a.m. PST",1235,1251,297,-938
SCL,"2/13/2025 3 a.m. PST",1234,1247,299,-935
SCL,"2/13/2025 4 a.m. PST",1248,1260,213,-1035
SCL,"2/13/2025 5 a.m. PST",1299,1300,216,-1083
SCL,"2/13/2025 6 a.m. PST",1401,1402,548,-853
SCL,"2/13/2025 7 a.m. PST",1558,1549,716,-842
SCL,"2/13/2025 8 a.m. PST",1673,1664,719,-954
SCL,"2/13/2025 9 a.m. PST",1670,1686,717,-953
SCL,"2/13/2025 10 a.m. PST",1639,1663,796,-843
SCL,"2/13/2025 11 a.m. PST",1609,1627,583,-1026
SCL,"2/13/2025 12 p.m. PST",1586,1595,545,-1041
SCL,"2/13/2025 1 p.m. PST",1577,1564,546,-1031
SCL,"2/13/2025 2 p.m. PST",1582,1537,538,-1044
SCL,"2/13/2025 3 p.m. PST",1576,1521,452,-1124
SCL,"2/13/2025 4 p.m. PST",1590,1532,520,-1070
SCL,"2/13/2025 5 p.m. PST",1613,1570,750,-863
SCL,"2/13/2025 6 p.m. PST",1656,1625,814,-842
SCL,"2/13/2025 7 p.m. PST",1657,1627,820,-837
SCL,"2/13/2025 8 p.m. PST",1617,1592,648,-969
SCL,"2/13/2025 9 p.m. PST",1573,1546,548,-1025
SCL,"2/13/2025 10 p.m. PST",1481,1477,481,-1000
SCL,"2/13/2025 11 p.m. PST",1380,1376,477,-903
SCL,"2/14/2025 12 a.m. PST",1286,1290,288,-998
SCL,"2/14/2025 1 a.m. PST",1229,1251,295,-934
SCL,"2/14/2025 2 a.m. PST",1188,1217,295,-893
SCL,"2/14/2025 3 a.m. PST",1169,1207,211,-958
SCL,"2/14/2025 4 a.m. PST",1180,1215,210,-970
SCL,"2/14/2025 5 a.m. PST",1225,1254,302,-923
SCL,"2/14/2025 6 a.m. PST",1321,1352,535,-786
SCL,"2/14/2025 7 a.m. PST",1459,1493,543,-916
SCL,"2/14/2025 8 a.m. PST",1571,1606,643,-928
SCL,"2/14/2025 9 a.m. PST",1613,1640,641,-972
SCL,"2/14/2025 10 a.m. PST",1645,1627,557,-1088
SCL,"2/14/2025 11 a.m. PST",1619,1596,468,-1151
SCL,"2/14/2025 12 p.m. PST",1605,1560,460,-1145
SCL,"2/14/2025 1 p.m. PST",1597,1529,465,-1132
SCL,"2/14/2025 2 p.m. PST",1561,1505,458,-1103
SCL,"2/14/2025 3 p.m. PST",1536,1483,349,-1187
SCL,"2/14/2025 4 p.m. PST",1537,1469,346,-1191
SCL,"2/14/2025 5 p.m. PST",1534,1484,564,-970
SCL,"2/14/2025 6 p.m. PST",1590,1532,654,-936
SCL,"2/14/2025 7 p.m. PST",1576,1530,681,-895
SCL,"2/14/2025 8 p.m. PST",1514,1498,597,-917
SCL,"2/14/2025 9 p.m. PST",1423,1454,496,-927
SCL,"2/14/2025 10 p.m. PST",1388,1397,498,-890
SCL,"2/14/2025 11 p.m. PST",1328,1332,318,-1010
SCL,"2/15/2025 12 a.m. PST",1255,1257,315,-940
SCL,"2/15/2025 1 a.m. PST",1176,1172,321,-855
SCL,"2/15/2025 2 a.m. PST",1141,1130,299,-842
SCL,"2/15/2025 3 a.m. PST",1132,1110,299,-833
SCL,"2/15/2025 4 a.m. PST",1113,1106,297,-816
SCL,"2/15/2025 5 a.m. PST",1124,1123,300,-824
SCL,"2/15/2025 6 a.m. PST",1166,1169,366,-800
SCL,"2/15/2025 7 a.m. PST",1223,1240,465,-758
SCL,"2/15/2025 8 a.m. PST",1292,1316,477,-815
SCL,"2/15/2025 9 a.m. PST",1352,1382,532,-820
SCL,"2/15/2025 10 a.m. PST",1396,1418,481,-915
SCL,"2/15/2025 11 a.m. PST",1399,1420,425,-974
SCL,"2/15/2025 12 p.m. PST",1411,1401,326,-1085
SCL,"2/15/2025 1 p.m. PST",1394,1386,316,-1078
SCL,"2/15/2025 2 p.m. PST",1382,1352,341,-1041
SCL,"2/15/2025 3 p.m. PST",1379,1348,372,-1007
SCL,"2/15/2025 4 p.m. PST",1386,1349,409,-977
SCL,"2/15/2025 5 p.m. PST",1387,1372,803,-584
SCL,"2/15/2025 6 p.m. PST",1414,1423,880,-534
SCL,"2/15/2025 7 p.m. PST",1417,1449,736,-681
SCL,"2/15/2025 8 p.m. PST",1410,1424,682,-728
SCL,"2/15/2025 9 p.m. PST",1360,1387,627,-733
SCL,"2/15/2025 10 p.m. PST",1327,1329,473,-854
SCL,"2/15/2025 11 p.m. PST",1256,1267,466,-790
SCL,"2/16/2025 12 a.m. PST",1201,1198,458,-743
SCL,"2/16/2025 1 a.m. PST",1152,1120,418,-734
SCL,"2/16/2025 2 a.m. PST",1111,1080,325,-786
SCL,"2/16/2025 3 a.m. PST",1094,1061,337,-757
SCL,"2/16/2025 4 a.m. PST",1085,1054,337,-748
SCL,"2/16/2025 5 a.m. PST",1085,1058,346,-739
SCL,"2/16/2025 6 a.m. PST",1115,1086,442,-673
SCL,"2/16/2025 7 a.m. PST",1172,1138,497,-675
SCL,"2/16/2025 8 a.m. PST",1219,1186,524,-695
SCL,"2/16/2025 9 a.m. PST",1253,1241,539,-714
SCL,"2/16/2025 10 a.m. PST",1313,1285,494,-819
SCL,"2/16/2025 11 a.m. PST",1339,1300,407,-932
SCL,"2/16/2025 12 p.m. PST",1332,1291,410,-922
SCL,"2/16/2025 1 p.m. PST",1323,1286,427,-896
SCL,"2/16/2025 2 p.m. PST",1288,1274,425,-863
SCL,"2/16/2025 3 p.m. PST",1259,1263,463,-796
SCL,"2/16/2025 4 p.m. PST",1271,1264,605,-666
SCL,"2/16/2025 5 p.m. PST",1301,1292,845,-456
SCL,"2/16/2025 6 p.m. PST",1341,1351,829,-512
SCL,"2/16/2025 7 p.m. PST",1361,1386,810,-551
SCL,"2/16/2025 8 p.m. PST",1345,1371,795,-550
SCL,"2/16/2025 9 p.m. PST",1309,1342,593,-716
SCL,"2/16/2025 10 p.m. PST",1245,1288,541,-704
SCL,"2/16/2025 11 p.m. PST",1182,1208,559,-623
SCL,"2/17/2025 12 a.m. PST",1132,1127,464,-668
SCL,"2/17/2025 1 a.m. PST",1081,1034,403,-678
SCL,"2/17/2025 2 a.m. PST",1056,1010,334,-722
SCL,"2/17/2025 3 a.m. PST",1044,998,326,-718
SCL,"2/17/2025 4 a.m. PST",1047,1005,308,-739
SCL,"2/17/2025 5 a.m. PST",1088,1042,398,-690
SCL,"2/17/2025 6 a.m. PST",1168,1114,442,-726
SCL,"2/17/2025 7 a.m. PST",1261,1215,511,-750
SCL,"2/17/2025 8 a.m. PST",1327,1280,575,-752
SCL,"2/17/2025 9 a.m. PST",1368,1322,446,-922
SCL,"2/17/2025 10 a.m. PST",1398,1348,428,-970
SCL,"2/17/2025 11 a.m. PST",1408,1364,393,-1015
SCL,"2/17/2025 12 p.m. PST",1404,1373,395,-1009
SCL,"2/17/2025 1 p.m. PST",1386,1378,395,-991
SCL,"2/17/2025 2 p.m. PST",1358,1360,391,-967
SCL,"2/17/2025 3 p.m. PST",1345,1335,400,-945
SCL,"2/17/2025 4 p.m. PST",1353,1337,558,-795
SCL,"2/17/2025 5 p.m. PST",1367,1348,680,-687
SCL,"2/17/2025 6 p.m. PST",1403,1386,659,-744
SCL,"2/17/2025 7 p.m. PST",1407,1380,651,-756
SCL,"2/17/2025 8 p.m. PST",1375,1350,647,-728
SCL,"2/17/2025 9 p.m. PST",1326,1307,653,-673
SCL,"2/17/2025 10 p.m. PST",1261,1244,601,-660
SCL,"2/17/2025 11 p.m. PST",1185,1160,427,-758
SCL,"2/18/2025 12 a.m. PST",1112,1078,428,-684
SCL,"2/18/2025 1 a.m. PST",1062,1025,343,-719
SCL,"2/18/2025 2 a.m. PST",1026,987,326,-700
SCL,"2/18/2025 3 a.m. PST",1008,972,326,-682
SCL,"2/18/2025 4 a.m. PST",1020,977,328,-692
SCL,"2/18/2025 5 a.m. PST",1055,1016,338,-717
SCL,"2/18/2025 6 a.m. PST",1150,1110,544,-606
SCL,"2/18/2025 7 a.m. PST",1278,1248,757,-521
SCL,"2/18/2025 8 a.m. PST",1361,1350,676,-685
SCL,"2/18/2025 9 a.m. PST",1389,1373,770,-619
SCL,"2/18/2025 10 a.m. PST",1379,1353,737,-642
SCL,"2/18/2025 11 a.m. PST",1352,1328,651,-701
SCL,"2/18/2025 12 p.m. PST",1295,1304,596,-699
SCL,"2/18/2025 1 p.m. PST",1288,1281,601,-687
SCL,"2/18/2025 2 p.m. PST",1273,1256,573,-700
SCL,"2/18/2025 3 p.m. PST",1246,1232,582,-664
SCL,"2/18/2025 4 p.m. PST",1239,1213,579,-660
SCL,"2/18/2025 5 p.m. PST",1264,1245,677,-587
SCL,"2/18/2025 6 p.m. PST",1329,1309,673,-656
SCL,"2/18/2025 7 p.m. PST",1331,1341,684,-647
SCL,"2/18/2025 8 p.m. PST",1311,1315,669,-642
SCL,"2/18/2025 9 p.m. PST",1271,1278,645,-626
SCL,"2/18/2025 10 p.m. PST",1224,1217,628,-596
SCL,"2/18/2025 11 p.m. PST",1149,1130,626,-523
SCL,"2/19/2025 12 a.m. PST",1069,1050,467,-602
SCL,"2/19/2025 1 a.m. PST",1020,970,332,-688
SCL,"2/19/2025 2 a.m. PST",975,939,379,-596
SCL,"2/19/2025 3 a.m. PST",927,924,328,-599
SCL,"2/19/2025 4 a.m. PST",930,933,353,-577
SCL,"2/19/2025 5 a.m. PST",970,976,383,-587
SCL,"2/19/2025 6 a.m. PST",1068,1072,561,-507
SCL,"2/19/2025 7 a.m. PST",1197,1210,717,-480
SCL,"2/19/2025 8 a.m. PST",1292,1308,666,-626
SCL,"2/19/2025 9 a.m. PST",1322,1334,632,-690
SCL,"2/19/2025 10 a.m. PST",1322,1323,660,-662
SCL,"2/19/2025 11 a.m. PST",1310,1310,484,-826
SCL,"2/19/2025 12 p.m. PST",1284,1297,400,-884
SCL,"2/19/2025 1 p.m. PST",1274,1287,387,-887
SCL,"2/19/2025 2 p.m. PST",1232,1269,386,-846
SCL,"2/19/2025 3 p.m. PST",1200,1243,381,-819
SCL,"2/19/2025 4 p.m. PST",1214,1249,483,-731
SCL,"2/19/2025 5 p.m. PST",1269,1276,678,-591
SCL,"2/19/2025 6 p.m. PST",1313,1324,683,-630
SCL,"2/19/2025 7 p.m. PST",1332,1346,697,-635
SCL,"2/19/2025 8 p.m. PST",1306,1319,668,-638
SCL,"2/19/2025 9 p.m. PST",1271,1276,622,-649
SCL,"2/19/2025 10 p.m. PST",1210,1214,603,-607
SCL,"2/19/2025 11 p.m. PST",1134,1130,493,-641
SCL,"2/20/2025 12 a.m. PST",1057,1049,395,-662
SCL,"2/20/2025 1 a.m. PST",999,1006,233,-766
SCL,"2/20/2025 2 a.m. PST",962,977,230,-732
SCL,"2/20/2025 3 a.m. PST",948,960,234,-714
SCL,"2/20/2025 4 a.m. PST",953,962,230,-723
SCL,"2/20/2025 5 a.m. PST",996,994,236,-760
SCL,"2/20/2025 6 a.m. PST",1098,1080,369,-729
SCL,"2/20/2025 7 a.m. PST",1231,1213,543,-688
SCL,"2/20/2025 8 a.m. PST",1324,1305,567,-757
SCL,"2/20/2025 9 a.m. PST",1332,1320,568,-764
SCL,"2/20/2025 10 a.m. PST",1329,1300,543,-786
SCL,"2/20/2025 11 a.m. PST",1290,1279,389,-901
SCL,"2/20/2025 12 p.m. PST",1280,1260,387,-893
SCL,"2/20/2025 1 p.m. PST",1270,1244,350,-920
SCL,"2/20/2025 2 p.m. PST",1272,1221,349,-923
SCL,"2/20/2025 3 p.m. PST",1252,1191,356,-896
SCL,"2/20/2025 4 p.m. PST",1256,1195,389,-867
SCL,"2/20/2025 5 p.m. PST",1272,1219,684,-588
SCL,"2/20/2025 6 p.m. PST",1312,1275,793,-519
SCL,"2/20/2025 7 p.m. PST",1314,1300,709,-605
SCL,"2/20/2025 8 p.m. PST",1292,1276,675,-617
SCL,"2/20/2025 9 p.m. PST",1250,1243,647,-603
SCL,"2/20/2025 10 p.m. PST",1199,1191,624,-575
SCL,"2/20/2025 11 p.m. PST",1125,1114,480,-645
SCL,"2/21/2025 12 a.m. PST",1053,1044,406,-647
SCL,"2/21/2025 1 a.m. PST",1000,1004,242,-758
SCL,"2/21/2025 2 a.m. PST",974,972,252,-722
SCL,"2/21/2025 3 a.m. PST",951,956,251,-700
SCL,"2/21/2025 4 a.m. PST",960,959,250,-710
SCL,"2/21/2025 5 a.m. PST",996,998,254,-742
SCL,"2/21/2025 6 a.m. PST",1091,1093,507,-584
SCL,"2/21/2025 7 a.m. PST",1211,1229,766,-445
SCL,"2/21/2025 8 a.m. PST",1294,1324,693,-601
SCL,"2/21/2025 9 a.m. PST",1331,1346,618,-713
SCL,"2/21/2025 10 a.m. PST",1341,1325,781,-560
SCL,"2/21/2025 11 a.m. PST",1350,1295,620,-730
SCL,"2/21/2025 12 p.m. PST",1350,1262,596,-754
SCL,"2/21/2025 1 p.m. PST",1335,1227,490,-845
SCL,"2/21/2025 2 p.m. PST",1343,1202,487,-856
SCL,"2/21/2025 3 p.m. PST",1339,1190,494,-845
SCL,"2/21/2025 4 p.m. PST",1329,1182,508,-821
SCL,"2/21/2025 5 p.m. PST",1360,1201,671,-689
SCL,"2/21/2025 6 p.m. PST",1381,1244,831,-550
SCL,"2/21/2025 7 p.m. PST",1361,1252,827,-534
SCL,"2/21/2025 8 p.m. PST",1326,1221,836,-490
SCL,"2/21/2025 9 p.m. PST",1287,1182,677,-610
SCL,"2/21/2025 10 p.m. PST",1227,1134,675,-552
SCL,"2/21/2025 11 p.m. PST",1163,1083,510,-653
SCL,"2/22/2025 12 a.m. PST",1094,1019,506,-588
SCL,"2/22/2025 1 a.m. PST",1029,1002,348,-681
SCL,"2/22/2025 2 a.m. PST",990,958,353,-637
SCL,"2/22/2025 3 a.m. PST",972,934,257,-715
SCL,"2/22/2025 4 a.m. PST",951,926,250,-701
SCL,"2/22/2025 5 a.m. PST",963,935,252,-711
SCL,"2/22/2025 6 a.m. PST",999,970,357,-642
SCL,"2/22/2025 7 a.m. PST",1055,1026,377,-678
SCL,"2/22/2025 8 a.m. PST",1107,1077,459,-648
SCL,"2/22/2025 9 a.m. PST",1170,1131,457,-713
SCL,"2/22/2025 10 a.m. PST",1202,1173,329,-873
SCL,"2/22/2025 11 a.m. PST",1228,1189,303,-925
SCL,"2/22/2025 12 p.m. PST",1238,1176,307,-931
SCL,"2/22/2025 1 p.m. PST",1222,1160,297,-925
SCL,"2/22/2025 2 p.m. PST",1188,1123,286,-902
SCL,"2/22/2025 3 p.m. PST",1214,1105,264,-950
SCL,"2/22/2025 4 p.m. PST",1233,1116,311,-922
SCL,"2/22/2025 5 p.m. PST",1261,1135,543,-718
SCL,"2/22/2025 6 p.m. PST",1285,1181,674,-611
SCL,"2/22/2025 7 p.m. PST",1284,1209,730,-554
SCL,"2/22/2025 8 p.m. PST",1247,1181,679,-568
SCL,"2/22/2025 9 p.m. PST",1214,1143,642,-572
SCL,"2/22/2025 10 p.m. PST",1161,1100,517,-644
SCL,"2/22/2025 11 p.m. PST",1087,1053,477,-610
SCL,"2/23/2025 12 a.m. PST",1060,993,315,-745
SCL,"2/23/2025 1 a.m. PST",996,966,306,-690
SCL,"2/23/2025 2 a.m. PST",965,933,344,-621
SCL,"2/23/2025 3 a.m. PST",943,910,339,-604
SCL,"2/23/2025 4 a.m. PST",932,899,338,-594
SCL,"2/23/2025 5 a.m. PST",910,901,332,-578
SCL,"2/23/2025 6 a.m. PST",954,926,336,-618
SCL,"2/23/2025 7 a.m. PST",1003,973,390,-613
SCL,"2/23/2025 8 a.m. PST",1049,1012,515,-534
SCL,"2/23/2025 9 a.m. PST",1106,1066,471,-635
SCL,"2/23/2025 10 a.m. PST",1104,1108,298,-806
SCL,"2/23/2025 11 a.m. PST",1184,1131,247,-937
SCL,"2/23/2025 12 p.m. PST",1198,1139,208,-990
SCL,"2/23/2025 1 p.m. PST",1216,1140,325,-891
SCL,"2/23/2025 2 p.m. PST",1214,1139,271,-943
SCL,"2/23/2025 3 p.m. PST",1238,1136,292,-946
SCL,"2/23/2025 4 p.m. PST",1243,1132,513,-730
SCL,"2/23/2025 5 p.m. PST",1252,1130,771,-481
SCL,"2/23/2025 6 p.m. PST",1260,1187,801,-459
SCL,"2/23/2025 7 p.m. PST",1308,1221,812,-496
SCL,"2/23/2025 8 p.m. PST",1285,1205,819,-466
SCL,"2/23/2025 9 p.m. PST",1282,1183,785,-497
SCL,"2/23/2025 10 p.m. PST",1231,1142,668,-563
SCL,"2/23/2025 11 p.m. PST",1152,1076,583,-569
SCL,"2/24/2025 12 a.m. PST",1079,999,566,-513
SCL,"2/24/2025 1 a.m. PST",1010,978,400,-610
SCL,"2/24/2025 2 a.m. PST",973,943,380,-593
SCL,"2/24/2025 3 a.m. PST",957,929,352,-605
SCL,"2/24/2025 4 a.m. PST",959,936,360,-599
SCL,"2/24/2025 5 a.m. PST",1008,974,364,-644
SCL,"2/24/2025 6 a.m. PST",1116,1065,503,-613
SCL,"2/24/2025 7 a.m. PST",1259,1202,721,-538
SCL,"2/24/2025 8 a.m. PST",1353,1291,746,-607
SCL,"2/24/2025 9 a.m. PST",1367,1306,814,-553
SCL,"2/24/2025 10 a.m. PST",1333,1294,675,-658
SCL,"2/24/2025 11 a.m. PST",1325,1281,404,-921
SCL,"2/24/2025 12 p.m. PST",1377,1268,437,-940
SCL,"2/24/2025 1 p.m. PST",1387,1261,355,-1032
SCL,"2/24/2025 2 p.m. PST",1390,1249,380,-1010
SCL,"2/24/2025 3 p.m. PST",1356,1213,370,-986
SCL,"2/24/2025 4 p.m. PST",1330,1201,382,-948
SCL,"2/24/2025 5 p.m. PST",1338,1215,723,-615
SCL,"2/24/2025 6 p.m. PST",1369,1266,799,-570
SCL,"2/24/2025 7 p.m. PST",1380,1296,726,-654
SCL,"2/24/2025 8 p.m. PST",1351,1267,750,-601
SCL,"2/24/2025 9 p.m. PST",1320,1226,655,-665
SCL,"2/24/2025 10 p.m. PST",1247,1163,567,-680
SCL,"2/24/2025 11 p.m. PST",1167,1079,448,-719
SCL,"2/25/2025 12 a.m. PST",1082,997,350,-732
SCL,"2/25/2025 1 a.m. PST",1025,987,389,-636
SCL,"2/25/2025 2 a.m. PST",992,949,392,-600
SCL,"2/25/2025 3 a.m. PST",980,932,388,-592
SCL,"2/25/2025 4 a.m. PST",972,935,391,-581
SCL,"2/25/2025 5 a.m. PST",1022,970,406,-616
SCL,"2/25/2025 6 a.m. PST",1108,1059,533,-575
SCL,"2/25/2025 7 a.m. PST",1230,1187,585,-645
SCL,"2/25/2025 8 a.m. PST",1364,1280,592,-772
SCL,"2/25/2025 9 a.m. PST",1398,1300,550,-848
SCL,"2/25/2025 10 a.m. PST",1399,1285,533,-866
SCL,"2/25/2025 11 a.m. PST",1408,1264,302,-1106
SCL,"2/25/2025 12 p.m. PST",1393,1251,296,-1097
SCL,"2/25/2025 1 p.m. PST",1351,1238,162,-1189
SCL,"2/25/2025 2 p.m. PST",1305,1227,143,-1162
SCL,"2/25/2025 3 p.m. PST",1298,1205,151,-1147
SCL,"2/25/2025 4 p.m. PST",1268,1200,161,-1107
SCL,"2/25/2025 5 p.m. PST",1298,1221,213,-1085
SCL,"2/25/2025 6 p.m. PST",1360,1277,560,-800
SCL,"2/25/2025 7 p.m. PST",1399,1309,621,-778
SCL,"2/25/2025 8 p.m. PST",1381,1285,580,-801
SCL,"2/25/2025 9 p.m. PST",1342,1249,581,-761
SCL,"2/25/2025 10 p.m. PST",1280,1196,474,-806
SCL,"2/25/2025 11 p.m. PST",1193,1113,457,-736
SCL,"2/26/2025 12 a.m. PST",1123,1038,380,-743
SCL,"2/26/2025 1 a.m. PST",1066,1026,225,-841
SCL,"2/26/2025 2 a.m. PST",1026,993,195,-831
SCL,"2/26/2025 3 a.m. PST",987,977,182,-805
SCL,"2/26/2025 4 a.m. PST",977,980,177,-800
SCL,"2/26/2025 5 a.m. PST",1033,1015,178,-855
SCL,"2/26/2025 6 a.m. PST",1136,1110,407,-729
SCL,"2/26/2025 7 a.m. PST",1301,1248,599,-702
SCL,"2/26/2025 8 a.m. PST",1399,1342,526,-873
SCL,"2/26/2025 9 a.m. PST",1376,1332,499,-877
SCL,"2/26/2025 10 a.m. PST",1297,1293,507,-790
SCL,"2/26/2025 11 a.m. PST",1288,1249,470,-818
SCL,"2/26/2025 12 p.m. PST",1229,1207,170,-1059
SCL,"2/26/2025 1 p.m. PST",1179,1163,118,-1061
SCL,"2/26/2025 2 p.m. PST",1169,1136,116,-1053
SCL,"2/26/2025 3 p.m. PST",1161,1113,115,-1046
SCL,"2/26/2025 4 p.m. PST",1153,1107,115,-1038
SCL,"2/26/2025 5 p.m. PST",1156,1127,558,-598
SCL,"2/26/2025 6 p.m. PST",1202,1183,742,-460
SCL,"2/26/2025 7 p.m. PST",1244,1223,768,-476
SCL,"2/26/2025 8 p.m. PST",1237,1220,764,-473
SCL,"2/26/2025 9 p.m. PST",1210,1190,682,-528
SCL,"2/26/2025 10 p.m. PST",1157,1141,663,-494
SCL,"2/26/2025 11 p.m. PST",1080,1070,635,-445
SCL,"2/27/2025 12 a.m. PST",1006,997,438,-568
SCL,"2/27/2025 1 a.m. PST",951,951,495,-456
SCL,"2/27/2025 2 a.m. PST",921,924,390,-531
SCL,"2/27/2025 3 a.m. PST",900,909,387,-513
SCL,"2/27/2025 4 a.m. PST",919,915,390,-529
SCL,"2/27/2025 5 a.m. PST",958,957,389,-569
SCL,"2/27/2025 6 a.m. PST",1066,1054,614,-452
SCL,"2/27/2025 7 a.m. PST",1209,1186,644,-565
SCL,"2/27/2025 8 a.m. PST",1305,1278,608,-697
SCL,"2/27/2025 9 a.m. PST",1280,1284,491,-789
SCL,"2/27/2025 10 a.m. PST",1215,1259,480,-735
SCL,"2/27/2025 11 a.m. PST",1170,1233,287,-883
SCL,"2/27/2025 12 p.m. PST",1143,1208,270,-873
SCL,"2/27/2025 1 p.m. PST",1117,1196,166,-951
SCL,"2/27/2025 2 p.m. PST",1107,1183,157,-950
SCL,"2/27/2025 3 p.m. PST",1084,1161,173,-911
SCL,"2/27/2025 4 p.m. PST",1074,1152,179,-895
SCL,"2/27/2025 5 p.m. PST",1088,1169,483,-605
SCL,"2/27/2025 6 p.m. PST",1118,1215,720,-398
SCL,"2/27/2025 7 p.m. PST",1153,1241,695,-458
SCL,"2/27/2025 8 p.m. PST",1153,1231,705,-448
SCL,"2/27/2025 9 p.m. PST",1137,1198,691,-446
SCL,"2/27/2025 10 p.m. PST",1092,1153,701,-391
SCL,"2/27/2025 11 p.m. PST",1027,1084,466,-561
SCL,"2/28/2025 12 a.m. PST",958,1015,448,-510
SCL,"2/28/2025 1 a.m. PST",907,911,319,-588
SCL,"2/28/2025 2 a.m. PST",879,884,297,-582
SCL,"2/28/2025 3 a.m. PST",864,866,287,-577
SCL,"2/28/2025 4 a.m. PST",870,869,255,-615
SCL,"2/28/2025 5 a.m. PST",909,908,429,-480
SCL,"2/28/2025 6 a.m. PST",1003,1003,506,-497
SCL,"2/28/2025 7 a.m. PST",1149,1144,599,-550
SCL,"2/28/2025 8 a.m. PST",1246,1235,618,-628
SCL,"2/28/2025 9 a.m. PST",1245,1254,484,-761
SCL,"2/28/2025 10 a.m. PST",1228,1230,487,-741
SCL,"2/28/2025 11 a.m. PST",1213,1204,451,-762
SCL,"2/28/2025 12 p.m. PST",1197,1169,271,-926
SCL,"2/28/2025 1 p.m. PST",1179,1140,296,-883
SCL,"2/28/2025 2 p.m. PST",1151,1116,295,-856
SCL,"2/28/2025 3 p.m. PST",1125,1097,294,-831
SCL,"2/28/2025 4 p.m. PST",1123,1086,434,-689
SCL,"2/28/2025 5 p.m. PST",1110,1097,658,-452
SCL,"2/28/2025 6 p.m. PST",1164,1134,751,-413
SCL,"2/28/2025 7 p.m. PST",1196,1167,712,-484
SCL,"2/28/2025 8 p.m. PST",1181,1150,709,-472
SCL,"2/28/2025 9 p.m. PST",1165,1121,697,-468
SCL,"2/28/2025 10 p.m. PST",1118,1082,611,-507
SCL,"2/28/2025 11 p.m. PST",1046,1042,526,-520