"BA Code","Timestamp (Hour Ending)","Demand (MWh)","Demand Forecast (MWh)","Net Generation (MWh)","Total Interchange (MWh)"
SCL,"7/1/2024 12 a.m. PDT",893,856,712,-181
SCL,"7/1/2024 1 a.m. PDT",830,795,444,-386
SCL,"7/1/2024 2 a.m. PDT",786,754,397,-389
SCL,"7/1/2024 3 a.m. PDT",769,730,346,-423
SCL,"7/1/2024 4 a.m. PDT",763,723,347,-416
SCL,"7/1/2024 5 a.m. PDT",779,735,390,-389
SCL,"7/1/2024 6 a.m. PDT",821,769,425,-396
SCL,"7/1/2024 7 a.m. PDT",898,838,665,-233
SCL,"7/1/2024 8 a.m. PDT",972,906,727,-245
SCL,"7/1/2024 9 a.m. PDT",1045,944,782,-263
SCL,"7/1/2024 10 a.m. PDT",1065,965,795,-270
SCL,"7/1/2024 11 a.m. PDT",1083,979,729,-354
SCL,"7/1/2024 12 p.m. PDT",1091,994,824,-267
SCL,"7/1/2024 1 p.m. PDT",1070,1005,708,-362
SCL,"7/1/2024 2 p.m. PDT",1076,1013,692,-384
SCL,"7/1/2024 3 p.m. PDT",1072,1018,680,-392
SCL,"7/1/2024 4 p.m. PDT",1084,1024,681,-403
SCL,"7/1/2024 5 p.m. PDT",1092,1039,690,-402
SCL,"7/1/2024 6 p.m. PDT",1090,1050,794,-296
SCL,"7/1/2024 7 p.m. PDT",1071,1020,812,-259
SCL,"7/1/2024 8 p.m. PDT",1042,994,807,-235
SCL,"7/1/2024 9 p.m. PDT",1008,973,785,-223
SCL,"7/1/2024 10 p.m. PDT",985,958,946,-39
SCL,"7/1/2024 11 p.m. PDT",936,912,568,-368
SCL,"7/2/2024 12 a.m. PDT",853,844,506,-347
SCL,"7/2/2024 1 a.m. PDT",779,790,517,-262
SCL,"7/2/2024 2 a.m. PDT",735,747,499,-236
SCL,"7/2/2024 3 a.m. PDT",714,722,474,-240
SCL,"7/2/2024 4 a.m. PDT",702,715,476,-226
SCL,"7/2/2024 5 a.m. PDT",713,731,511,-202
SCL,"7/2/2024 6 a.m. PDT",749,770,562,-187
SCL,"7/2/2024 7 a.m. PDT",824,848,796,-28
SCL,"7/2/2024 8 a.m. PDT",914,924,840,-74
SCL,"7/2/2024 9 a.m. PDT",953,965,821,-132
SCL,"7/2/2024 10 a.m. PDT",963,982,870,-93
SCL,"7/2/2024 11 a.m. PDT",983,992,759,-224
SCL,"7/2/2024 12 p.m. PDT",972,1004,775,-197
SCL,"7/2/2024 1 p.m. PDT",987,1017,796,-191
SCL,"7/2/2024 2 p.m. PDT",990,1026,722,-268
SCL,"7/2/2024 3 p.m. PDT",994,1032,694,-300
SCL,"7/2/2024 4 p.m. PDT",1005,1037,718,-287
SCL,"7/2/2024 5 p.m. PDT",1020,1050,748,-272
SCL,"7/2/2024 6 p.m. PDT",1043,1059,727,-316
SCL,"7/2/2024 7 p.m. PDT",1032,1042,890,-142
SCL,"7/2/2024 8 p.m. PDT",1007,1016,914,-93
SCL,"7/2/2024 9 p.m. PDT",981,994,871,-110
SCL,"7/2/2024 10 p.m. PDT",967,980,808,-159
SCL,"7/2/2024 11 p.m. PDT",909,932,582,-327
SCL,"7/3/2024 12 a.m. PDT",831,861,566,-265
SCL,"7/3/2024 1 a.m. PDT",769,778,446,-323
SCL,"7/3/2024 2 a.m. PDT",722,732,405,-317
SCL,"7/3/2024 3 a.m. PDT",702,710,419,-283
SCL,"7/3/2024 4 a.m. PDT",691,705,464,-227
SCL,"7/3/2024 5 a.m. PDT",703,722,460,-243
SCL,"7/3/2024 6 a.m. PDT",740,766,471,-269
SCL,"7/3/2024 7 a.m. PDT",820,843,849,29
SCL,"7/3/2024 8 a.m. PDT",888,921,843,-45
SCL,"7/3/2024 9 a.m. PDT",938,963,705,-233
SCL,"7/3/2024 10 a.m. PDT",960,979,701,-259
SCL,"7/3/2024 11 a.m. PDT",980,990,691,-289
SCL,"7/3/2024 12 p.m. PDT",981,1003,683,-298
SCL,"7/3/2024 1 p.m. PDT",1005,1018,701,-304
SCL,"7/3/2024 2 p.m. PDT",1001,1030,675,-326
SCL,"7/3/2024 3 p.m. PDT",1019,1038,700,-319
SCL,"7/3/2024 4 p.m. PDT",1036,1048,679,-357
SCL,"7/3/2024 5 p.m. PDT",1046,1060,674,-372
SCL,"7/3/2024 6 p.m. PDT",1062,1069,728,-334
SCL,"7/3/2024 7 p.m. PDT",1044,1041,899,-145
SCL,"7/3/2024 8 p.m. PDT",1018,1018,1021,3
SCL,"7/3/2024 9 p.m. PDT",999,995,1011,12
SCL,"7/3/2024 10 p.m. PDT",979,982,994,15
SCL,"7/3/2024 11 p.m. PDT",934,936,601,-333
SCL,"7/4/2024 12 a.m. PDT",859,863,485,-374
SCL,"7/4/2024 1 a.m. PDT",791,820,477,-314
SCL,"7/4/2024 2 a.m. PDT",745,759,445,-300
SCL,"7/4/2024 3 a.m. PDT",713,729,454,-259
SCL,"7/4/2024 4 a.m. PDT",698,714,428,-270
SCL,"7/4/2024 5 a.m. PDT",698,716,441,-257
SCL,"7/4/2024 6 a.m. PDT",708,730,508,-200
SCL,"7/4/2024 7 a.m. PDT",746,769,520,-226
SCL,"7/4/2024 8 a.m. PDT",794,809,646,-148
SCL,"7/4/2024 9 a.m. PDT",834,846,645,-189
SCL,"7/4/2024 10 a.m. PDT",885,877,686,-199
SCL,"7/4/2024 11 a.m. PDT",922,904,752,-170
SCL,"7/4/2024 12 p.m. PDT",945,919,719,-226
SCL,"7/4/2024 1 p.m. PDT",956,927,780,-176
SCL,"7/4/2024 2 p.m. PDT",965,945,785,-180
SCL,"7/4/2024 3 p.m. PDT",978,964,684,-294
SCL,"7/4/2024 4 p.m. PDT",993,977,675,-318
SCL,"7/4/2024 5 p.m. PDT",1005,996,686,-319
SCL,"7/4/2024 6 p.m. PDT",1009,1014,783,-226
SCL,"7/4/2024 7 p.m. PDT",992,1000,841,-151
SCL,"7/4/2024 8 p.m. PDT",978,981,970,-8
SCL,"7/4/2024 9 p.m. PDT",948,966,972,24
SCL,"7/4/2024 10 p.m. PDT",929,958,919,-10
SCL,"7/4/2024 11 p.m. PDT",883,923,628,-255
SCL,"7/5/2024 12 a.m. PDT",846,872,593,-253
SCL,"7/5/2024 1 a.m. PDT",804,791,541,-263
SCL,"7/5/2024 2 a.m. PDT",759,762,452,-307
SCL,"7/5/2024 3 a.m. PDT",727,734,467,-260
SCL,"7/5/2024 4 a.m. PDT",706,727,402,-304
SCL,"7/5/2024 5 a.m. PDT",718,748,464,-254
SCL,"7/5/2024 6 a.m. PDT",733,788,496,-237
SCL,"7/5/2024 7 a.m. PDT",801,869,674,-127
SCL,"7/5/2024 8 a.m. PDT",865,955,672,-193
SCL,"7/5/2024 9 a.m. PDT",922,1009,511,-411
SCL,"7/5/2024 10 a.m. PDT",976,1041,603,-373
SCL,"7/5/2024 11 a.m. PDT",1016,1061,765,-251
SCL,"7/5/2024 12 p.m. PDT",1040,1085,809,-231
SCL,"7/5/2024 1 p.m. PDT",1065,1105,921,-144
SCL,"7/5/2024 2 p.m. PDT",1079,1125,966,-113
SCL,"7/5/2024 3 p.m. PDT",1095,1141,942,-153
SCL,"7/5/2024 4 p.m. PDT",1124,1159,906,-218
SCL,"7/5/2024 5 p.m. PDT",1147,1178,880,-267
SCL,"7/5/2024 6 p.m. PDT",1168,1174,938,-230
SCL,"7/5/2024 7 p.m. PDT",1144,1137,993,-151
SCL,"7/5/2024 8 p.m. PDT",1119,1094,1018,-101
SCL,"7/5/2024 9 p.m. PDT",1087,1059,982,-105
SCL,"7/5/2024 10 p.m. PDT",1052,1039,911,-141
SCL,"7/5/2024 11 p.m. PDT",1002,998,705,-297
SCL,"7/6/2024 12 a.m. PDT",927,932,636,-291
SCL,"7/6/2024 1 a.m. PDT",863,873,372,-491
SCL,"7/6/2024 2 a.m. PDT",804,815,274,-530
SCL,"7/6/2024 3 a.m. PDT",774,780,292,-482
SCL,"7/6/2024 4 a.m. PDT",750,761,288,-462
SCL,"7/6/2024 5 a.m. PDT",740,762,288,-452
SCL,"7/6/2024 6 a.m. PDT",744,769,286,-458
SCL,"7/6/2024 7 a.m. PDT",767,805,665,-102
SCL,"7/6/2024 8 a.m. PDT",834,857,645,-189
SCL,"7/6/2024 9 a.m. PDT",918,911,686,-232
SCL,"7/6/2024 10 a.m. PDT",984,955,767,-217
SCL,"7/6/2024 11 a.m. PDT",1028,993,863,-165
SCL,"7/6/2024 12 p.m. PDT",1079,1018,761,-318
SCL,"7/6/2024 1 p.m. PDT",1098,1033,817,-281
SCL,"7/6/2024 2 p.m. PDT",1109,1046,906,-203
SCL,"7/6/2024 3 p.m. PDT",1125,1059,876,-249
SCL,"7/6/2024 4 p.m. PDT",1146,1079,846,-300
SCL,"7/6/2024 5 p.m. PDT",1179,1092,784,-395
SCL,"7/6/2024 6 p.m. PDT",1203,1111,790,-413
SCL,"7/6/2024 7 p.m. PDT",1218,1102,888,-330
SCL,"7/6/2024 8 p.m. PDT",1206,1083,1012,-194
SCL,"7/6/2024 9 p.m. PDT",1177,1058,963,-214
SCL,"7/6/2024 10 p.m. PDT",1154,1045,798,-356
SCL,"7/6/2024 11 p.m. PDT",1099,1008,559,-540
SCL,"7/7/2024 12 a.m. PDT",1021,945,498,-523
SCL,"7/7/2024 1 a.m. PDT",958,921,417,-541
SCL,"7/7/2024 2 a.m. PDT",895,859,356,-539
SCL,"7/7/2024 3 a.m. PDT",853,821,329,-524
SCL,"7/7/2024 4 a.m. PDT",838,797,293,-545
SCL,"7/7/2024 5 a.m. PDT",824,784,294,-530
SCL,"7/7/2024 6 a.m. PDT",808,776,294,-514
SCL,"7/7/2024 7 a.m. PDT",836,798,349,-487
SCL,"7/7/2024 8 a.m. PDT",883,846,347,-536
SCL,"7/7/2024 9 a.m. PDT",951,903,447,-504
SCL,"7/7/2024 10 a.m. PDT",1011,960,570,-441
SCL,"7/7/2024 11 a.m. PDT",1072,1002,627,-445
SCL,"7/7/2024 12 p.m. PDT",1112,1035,614,-498
SCL,"7/7/2024 1 p.m. PDT",1151,1062,683,-468
SCL,"7/7/2024 2 p.m. PDT",1178,1086,695,-483
SCL,"7/7/2024 3 p.m. PDT",1189,1109,755,-434
SCL,"7/7/2024 4 p.m. PDT",1213,1127,786,-427
SCL,"7/7/2024 5 p.m. PDT",1258,1154,771,-487
SCL,"7/7/2024 6 p.m. PDT",1295,1179,841,-454
SCL,"7/7/2024 7 p.m. PDT",1309,1178,966,-343
SCL,"7/7/2024 8 p.m. PDT",1305,1165,958,-347
SCL,"7/7/2024 9 p.m. PDT",1279,1138,858,-421
SCL,"7/7/2024 10 p.m. PDT",1248,1126,777,-471
SCL,"7/7/2024 11 p.m. PDT",1182,1081,572,-610
SCL,"7/8/2024 12 a.m. PDT",1086,1008,469,-617
SCL,"7/8/2024 1 a.m. PDT",1006,979,403,-603
SCL,"7/8/2024 2 a.m. PDT",933,912,358,-575
SCL,"7/8/2024 3 a.m. PDT",923,878,326,-597
SCL,"7/8/2024 4 a.m. PDT",898,862,351,-547
SCL,"7/8/2024 5 a.m. PDT",896,866,364,-532
SCL,"7/8/2024 6 a.m. PDT",931,890,408,-523
SCL,"7/8/2024 7 a.m. PDT",982,962,574,-408
SCL,"7/8/2024 8 a.m. PDT",1114,1038,665,-449
SCL,"7/8/2024 9 a.m. PDT",1177,1090,702,-475
SCL,"7/8/2024 10 a.m. PDT",1223,1127,681,-542
SCL,"7/8/2024 11 a.m. PDT",1254,1162,559,-695
SCL,"7/8/2024 12 p.m. PDT",1285,1189,595,-690
SCL,"7/8/2024 1 p.m. PDT",1322,1212,530,-792
SCL,"7/8/2024 2 p.m. PDT",1345,1235,622,-723
SCL,"7/8/2024 3 p.m. PDT",1373,1255,717,-656
SCL,"7/8/2024 4 p.m. PDT",1391,1275,1007,-384
SCL,"7/8/2024 5 p.m. PDT",1408,1295,928,-480
SCL,"7/8/2024 6 p.m. PDT",1433,1298,971,-462
SCL,"7/8/2024 7 p.m. PDT",1418,1260,1046,-372
SCL,"7/8/2024 8 p.m. PDT",1398,1224,1122,-276
SCL,"7/8/2024 9 p.m. PDT",1353,1187,990,-363
SCL,"7/8/2024 10 p.m. PDT",1306,1160,979,-327
SCL,"7/8/2024 11 p.m. PDT",1233,1097,611,-622
SCL,"7/9/2024 12 a.m. PDT",1122,1019,612,-510
SCL,"7/9/2024 1 a.m. PDT",1037,1016,246,-791
SCL,"7/9/2024 2 a.m. PDT",977,936,253,-724
SCL,"7/9/2024 3 a.m. PDT",939,897,184,-755
SCL,"7/9/2024 4 a.m. PDT",915,878,155,-760
SCL,"7/9/2024 5 a.m. PDT",926,883,156,-770
SCL,"7/9/2024 6 a.m. PDT",959,910,255,-704
SCL,"7/9/2024 7 a.m. PDT",1051,989,668,-383
SCL,"7/9/2024 8 a.m. PDT",1131,1074,756,-375
SCL,"7/9/2024 9 a.m. PDT",1204,1131,745,-459
SCL,"7/9/2024 10 a.m. PDT",1243,1176,699,-544
SCL,"7/9/2024 11 a.m. PDT",1258,1212,698,-560
SCL,"7/9/2024 12 p.m. PDT",1268,1249,645,-623
SCL,"7/9/2024 1 p.m. PDT",1296,1284,654,-642
SCL,"7/9/2024 2 p.m. PDT",1338,1312,678,-660
SCL,"7/9/2024 3 p.m. PDT",1364,1333,694,-670
SCL,"7/9/2024 4 p.m. PDT",1384,1351,732,-652
SCL,"7/9/2024 5 p.m. PDT",1402,1371,725,-677
SCL,"7/9/2024 6 p.m. PDT",1391,1377,875,-516
SCL,"7/9/2024 7 p.m. PDT",1367,1338,948,-419
SCL,"7/9/2024 8 p.m. PDT",1346,1294,958,-388
SCL,"7/9/2024 9 p.m. PDT",1312,1248,808,-504
SCL,"7/9/2024 10 p.m. PDT",1265,1222,759,-506
SCL,"7/9/2024 11 p.m. PDT",1188,1158,551,-637
SCL,"7/10/2024 12 a.m. PDT",1082,1069,402,-680
SCL,"7/10/2024 1 a.m. PDT",989,1008,230,-759
SCL,"7/10/2024 2 a.m. PDT",927,942,94,-833
SCL,"7/10/2024 3 a.m. PDT",887,901,145,-742
SCL,"7/10/2024 4 a.m. PDT",868,880,145,-723
SCL,"7/10/2024 5 a.m. PDT",867,881,274,-593
SCL,"7/10/2024 6 a.m. PDT",892,905,313,-579
SCL,"7/10/2024 7 a.m. PDT",972,970,658,-314
SCL,"7/10/2024 8 a.m. PDT",1053,1046,689,-364
SCL,"7/10/2024 9 a.m. PDT",1106,1098,672,-434
SCL,"7/10/2024 10 a.m. PDT",1137,1137,638,-499
SCL,"7/10/2024 11 a.m. PDT",1168,1171,644,-524
SCL,"7/10/2024 12 p.m. PDT",1194,1202,670,-524
SCL,"7/10/2024 1 p.m. PDT",1227,1233,677,-550
SCL,"7/10/2024 2 p.m. PDT",1255,1259,677,-578
SCL,"7/10/2024 3 p.m. PDT",1272,1279,688,-584
SCL,"7/10/2024 4 p.m. PDT",1291,1301,736,-555
SCL,"7/10/2024 5 p.m. PDT",1296,1315,712,-584
SCL,"7/10/2024 6 p.m. PDT",1305,1320,983,-322
SCL,"7/10/2024 7 p.m. PDT",1283,1278,955,-328
SCL,"7/10/2024 8 p.m. PDT",1251,1235,1010,-241
SCL,"7/10/2024 9 p.m. PDT",1207,1194,869,-338
SCL,"7/10/2024 10 p.m. PDT",1162,1170,808,-354
SCL,"7/10/2024 11 p.m. PDT",1082,1112,397,-685
SCL,"7/11/2024 12 a.m. PDT",989,1022,344,-645
SCL,"7/11/2024 1 a.m. PDT",901,929,245,-656
SCL,"7/11/2024 2 a.m. PDT",847,867,243,-604
SCL,"7/11/2024 3 a.m. PDT",811,832,289,-522
SCL,"7/11/2024 4 a.m. PDT",794,815,253,-541
SCL,"7/11/2024 5 a.m. PDT",808,821,244,-564
SCL,"7/11/2024 6 a.m. PDT",831,851,246,-585
SCL,"7/11/2024 7 a.m. PDT",910,923,574,-336
SCL,"7/11/2024 8 a.m. PDT",991,999,598,-393
SCL,"7/11/2024 9 a.m. PDT",1049,1048,598,-451
SCL,"7/11/2024 10 a.m. PDT",1074,1084,699,-375
SCL,"7/11/2024 11 a.m. PDT",1105,1116,701,-404
SCL,"7/11/2024 12 p.m. PDT",1123,1144,706,-417
SCL,"7/11/2024 1 p.m. PDT",1141,1169,705,-436
SCL,"7/11/2024 2 p.m. PDT",1161,1190,727,-434
SCL,"7/11/2024 3 p.m. PDT",1172,1203,777,-395
SCL,"7/11/2024 4 p.m. PDT",1193,1219,743,-450
SCL,"7/11/2024 5 p.m. PDT",1213,1234,712,-501
SCL,"7/11/2024 6 p.m. PDT",1221,1243,809,-412
SCL,"7/11/2024 7 p.m. PDT",1195,1205,899,-296
SCL,"7/11/2024 8 p.m. PDT",1163,1166,867,-296
SCL,"7/11/2024 9 p.m. PDT",1124,1133,920,-204
SCL,"7/11/2024 10 p.m. PDT",1088,1117,842,-246
SCL,"7/11/2024 11 p.m. PDT",1027,1062,420,-607
SCL,"7/12/2024 12 a.m. PDT",938,978,348,-590
SCL,"7/12/2024 1 a.m. PDT",871,881,143,-728
SCL,"7/12/2024 2 a.m. PDT",813,828,141,-672
SCL,"7/12/2024 3 a.m. PDT",783,797,140,-643
SCL,"7/12/2024 4 a.m. PDT",773,782,138,-635
SCL,"7/12/2024 5 a.m. PDT",777,792,222,-555
SCL,"7/12/2024 6 a.m. PDT",802,824,256,-546
SCL,"7/12/2024 7 a.m. PDT",878,894,537,-341
SCL,"7/12/2024 8 a.m. PDT",959,969,552,-407
SCL,"7/12/2024 9 a.m. PDT",1027,1017,702,-325
SCL,"7/12/2024 10 a.m. PDT",1078,1051,747,-331
SCL,"7/12/2024 11 a.m. PDT",1121,1071,738,-383
SCL,"7/12/2024 12 p.m. PDT",1157,1092,769,-388
SCL,"7/12/2024 1 p.m. PDT",1186,1111,684,-502
SCL,"7/12/2024 2 p.m. PDT",1186,1131,698,-488
SCL,"7/12/2024 3 p.m. PDT",1207,1147,737,-470
SCL,"7/12/2024 4 p.m. PDT",1228,1165,736,-492
SCL,"7/12/2024 5 p.m. PDT",1252,1185,684,-568
SCL,"7/12/2024 6 p.m. PDT",1236,1195,766,-470
SCL,"7/12/2024 7 p.m. PDT",1182,1151,769,-413
SCL,"7/12/2024 8 p.m. PDT",1157,1113,815,-342
SCL,"7/12/2024 9 p.m. PDT",1161,1078,729,-432
SCL,"7/12/2024 10 p.m. PDT",1125,1060,782,-343
SCL,"7/12/2024 11 p.m. PDT",1077,1016,434,-643
SCL,"7/13/2024 12 a.m. PDT",1009,948,404,-605
SCL,"7/13/2024 1 a.m. PDT",895,909,253,-642
SCL,"7/13/2024 2 a.m. PDT",843,854,245,-598
SCL,"7/13/2024 3 a.m. PDT",810,818,241,-569
SCL,"7/13/2024 4 a.m. PDT",827,794,242,-585
SCL,"7/13/2024 5 a.m. PDT",821,785,197,-624
SCL,"7/13/2024 6 a.m. PDT",816,783,196,-620
SCL,"7/13/2024 7 a.m. PDT",830,809,393,-437
SCL,"7/13/2024 8 a.m. PDT",900,860,513,-387
SCL,"7/13/2024 9 a.m. PDT",964,918,524,-440
SCL,"7/13/2024 10 a.m. PDT",1032,963,547,-485
SCL,"7/13/2024 11 a.m. PDT",1046,1001,539,-507
SCL,"7/13/2024 12 p.m. PDT",1089,1027,538,-551
SCL,"7/13/2024 1 p.m. PDT",1116,1044,601,-515
SCL,"7/13/2024 2 p.m. PDT",1117,1055,633,-484
SCL,"7/13/2024 3 p.m. PDT",1140,1067,707,-433
SCL,"7/13/2024 4 p.m. PDT",1151,1089,710,-441
SCL,"7/13/2024 5 p.m. PDT",1171,1107,731,-440
SCL,"7/13/2024 6 p.m. PDT",1201,1126,883,-318
SCL,"7/13/2024 7 p.m. PDT",1209,1132,932,-277
SCL,"7/13/2024 8 p.m. PDT",1194,1107,934,-260
SCL,"7/13/2024 9 p.m. PDT",1171,1079,812,-359
SCL,"7/13/2024 10 p.m. PDT",1143,1068,813,-330
SCL,"7/13/2024 11 p.m. PDT",1093,1025,384,-709
SCL,"7/14/2024 12 a.m. PDT",1020,955,334,-686
SCL,"7/14/2024 1 a.m. PDT",952,923,232,-720
SCL,"7/14/2024 2 a.m. PDT",903,865,197,-706
SCL,"7/14/2024 3 a.m. PDT",867,827,195,-672
SCL,"7/14/2024 4 a.m. PDT",840,801,254,-586
SCL,"7/14/2024 5 a.m. PDT",826,785,248,-578
SCL,"7/14/2024 6 a.m. PDT",821,777,283,-538
SCL,"7/14/2024 7 a.m. PDT",836,797,397,-439
SCL,"7/14/2024 8 a.m. PDT",897,841,404,-493
SCL,"7/14/2024 9 a.m. PDT",958,898,403,-555
SCL,"7/14/2024 10 a.m. PDT",1008,950,494,-514
SCL,"7/14/2024 11 a.m. PDT",1061,992,507,-554
SCL,"7/14/2024 12 p.m. PDT",1088,1023,509,-579
SCL,"7/14/2024 1 p.m. PDT",1095,1050,502,-593
SCL,"7/14/2024 2 p.m. PDT",1149,1071,504,-645
SCL,"7/14/2024 3 p.m. PDT",1180,1089,685,-495
SCL,"7/14/2024 4 p.m. PDT",1191,1109,715,-476
SCL,"7/14/2024 5 p.m. PDT",1204,1139,720,-484
SCL,"7/14/2024 6 p.m. PDT",1214,1167,911,-303
SCL,"7/14/2024 7 p.m. PDT",1221,1174,1012,-209
SCL,"7/14/2024 8 p.m. PDT",1197,1159,979,-218
SCL,"7/14/2024 9 p.m. PDT",1159,1131,869,-290
SCL,"7/14/2024 10 p.m. PDT",1158,1117,799,-359
SCL,"7/14/2024 11 p.m. PDT",1102,1067,584,-518
SCL,"7/15/2024 12 a.m. PDT",979,980,543,-436
SCL,"7/15/2024 1 a.m. PDT",930,907,150,-780
SCL,"7/15/2024 2 a.m. PDT",875,844,98,-777
SCL,"7/15/2024 3 a.m. PDT",838,813,94,-744
SCL,"7/15/2024 4 a.m. PDT",829,800,95,-734
SCL,"7/15/2024 5 a.m. PDT",827,807,131,-696
SCL,"7/15/2024 6 a.m. PDT",874,836,237,-637
SCL,"7/15/2024 7 a.m. PDT",924,901,563,-361
SCL,"7/15/2024 8 a.m. PDT",1013,973,570,-443
SCL,"7/15/2024 9 a.m. PDT",1039,1020,566,-473
SCL,"7/15/2024 10 a.m. PDT",1073,1046,569,-504
SCL,"7/15/2024 11 a.m. PDT",1077,1068,570,-507
SCL,"7/15/2024 12 p.m. PDT",1096,1084,569,-527
SCL,"7/15/2024 1 p.m. PDT",1106,1101,573,-533
SCL,"7/15/2024 2 p.m. PDT",1123,1117,586,-537
SCL,"7/15/2024 3 p.m. PDT",1102,1133,547,-555
SCL,"7/15/2024 4 p.m. PDT",1144,1147,727,-417
SCL,"7/15/2024 5 p.m. PDT",1206,1168,725,-481
SCL,"7/15/2024 6 p.m. PDT",1214,1178,882,-332
SCL,"7/15/2024 7 p.m. PDT",1221,1164,960,-261
SCL,"7/15/2024 8 p.m. PDT",1202,1131,922,-280
SCL,"7/15/2024 9 p.m. PDT",1172,1100,892,-280
SCL,"7/15/2024 10 p.m. PDT",1129,1083,707,-422
SCL,"7/15/2024 11 p.m. PDT",1078,1019,465,-613
SCL,"7/16/2024 12 a.m. PDT",984,938,410,-574
SCL,"7/16/2024 1 a.m. PDT",916,892,239,-677
SCL,"7/16/2024 2 a.m. PDT",863,829,243,-620
SCL,"7/16/2024 3 a.m. PDT",833,801,164,-669
SCL,"7/16/2024 4 a.m. PDT",816,789,140,-676
SCL,"7/16/2024 5 a.m. PDT",822,802,140,-682
SCL,"7/16/2024 6 a.m. PDT",820,842,135,-685
SCL,"7/16/2024 7 a.m. PDT",901,924,393,-508
SCL,"7/16/2024 8 a.m. PDT",996,1010,531,-465
SCL,"7/16/2024 9 a.m. PDT",1042,1058,576,-466
SCL,"7/16/2024 10 a.m. PDT",1081,1091,578,-503
SCL,"7/16/2024 11 a.m. PDT",1110,1116,581,-529
SCL,"7/16/2024 12 p.m. PDT",1138,1144,591,-547
SCL,"7/16/2024 1 p.m. PDT",1162,1166,643,-519
SCL,"7/16/2024 2 p.m. PDT",1199,1187,607,-592
SCL,"7/16/2024 3 p.m. PDT",1215,1200,610,-605
SCL,"7/16/2024 4 p.m. PDT",1247,1218,607,-640
SCL,"7/16/2024 5 p.m. PDT",1275,1246,614,-661
SCL,"7/16/2024 6 p.m. PDT",1286,1261,938,-348
SCL,"7/16/2024 7 p.m. PDT",1277,1234,1016,-261
SCL,"7/16/2024 8 p.m. PDT",1256,1196,942,-314
SCL,"7/16/2024 9 p.m. PDT",1225,1157,775,-450
SCL,"7/16/2024 10 p.m. PDT",1191,1138,632,-559
SCL,"7/16/2024 11 p.m. PDT",1109,1073,472,-637
SCL,"7/17/2024 12 a.m. PDT",1020,983,336,-684
SCL,"7/17/2024 1 a.m. PDT",939,943,143,-796
SCL,"7/17/2024 2 a.m. PDT",884,891,94,-790
SCL,"7/17/2024 3 a.m. PDT",844,857,93,-751
SCL,"7/17/2024 4 a.m. PDT",838,837,92,-746
SCL,"7/17/2024 5 a.m. PDT",842,837,89,-753
SCL,"7/17/2024 6 a.m. PDT",873,867,96,-777
SCL,"7/17/2024 7 a.m. PDT",960,939,390,-570
SCL,"7/17/2024 8 a.m. PDT",1046,1017,400,-646
SCL,"7/17/2024 9 a.m. PDT",1101,1063,407,-694
SCL,"7/17/2024 10 a.m. PDT",1127,1096,444,-683
SCL,"7/17/2024 11 a.m. PDT",1114,1122,426,-688
SCL,"7/17/2024 12 p.m. PDT",1137,1145,425,-712
SCL,"7/17/2024 1 p.m. PDT",1169,1170,424,-745
SCL,"7/17/2024 2 p.m. PDT",1209,1195,430,-779
SCL,"7/17/2024 3 p.m. PDT",1241,1215,458,-783
SCL,"7/17/2024 4 p.m. PDT",1262,1238,444,-818
SCL,"7/17/2024 5 p.m. PDT",1301,1259,602,-699
SCL,"7/17/2024 6 p.m. PDT",1314,1269,871,-443
SCL,"7/17/2024 7 p.m. PDT",1290,1233,841,-449
SCL,"7/17/2024 8 p.m. PDT",1261,1194,854,-407
SCL,"7/17/2024 9 p.m. PDT",1226,1157,690,-536
SCL,"7/17/2024 10 p.m. PDT",1182,1133,651,-531
SCL,"7/17/2024 11 p.m. PDT",1086,1065,373,-713
SCL,"7/18/2024 12 a.m. PDT",982,975,319,-663
SCL,"7/18/2024 1 a.m. PDT",895,918,156,-739
SCL,"7/18/2024 2 a.m. PDT",840,852,97,-743
SCL,"7/18/2024 3 a.m. PDT",800,818,92,-708
SCL,"7/18/2024 4 a.m. PDT",792,800,97,-695
SCL,"7/18/2024 5 a.m. PDT",792,806,95,-697
SCL,"7/18/2024 6 a.m. PDT",822,837,131,-691
SCL,"7/18/2024 7 a.m. PDT",898,909,390,-508
SCL,"7/18/2024 8 a.m. PDT",988,986,401,-587
SCL,"7/18/2024 9 a.m. PDT",1039,1033,405,-634
SCL,"7/18/2024 10 a.m. PDT",1064,1063,547,-517
SCL,"7/18/2024 11 a.m. PDT",1098,1087,533,-565
SCL,"7/18/2024 12 p.m. PDT",1109,1109,447,-662
SCL,"7/18/2024 1 p.m. PDT",1134,1128,424,-710
SCL,"7/18/2024 2 p.m. PDT",1177,1150,399,-778
SCL,"7/18/2024 3 p.m. PDT",1201,1166,405,-796
SCL,"7/18/2024 4 p.m. PDT",1217,1185,496,-721
SCL,"7/18/2024 5 p.m. PDT",1245,1205,611,-634
SCL,"7/18/2024 6 p.m. PDT",1267,1218,732,-535
SCL,"7/18/2024 7 p.m. PDT",1235,1189,632,-603
SCL,"7/18/2024 8 p.m. PDT",1215,1153,588,-627
SCL,"7/18/2024 9 p.m. PDT",1164,1116,507,-657
SCL,"7/18/2024 10 p.m. PDT",1127,1100,539,-588
SCL,"7/18/2024 11 p.m. PDT",1055,1038,335,-720
SCL,"7/19/2024 12 a.m. PDT",958,953,328,-630
SCL,"7/19/2024 1 a.m. PDT",882,904,128,-754
SCL,"7/19/2024 2 a.m. PDT",829,843,95,-734
SCL,"7/19/2024 3 a.m. PDT",796,811,88,-708
SCL,"7/19/2024 4 a.m. PDT",775,796,86,-689
SCL,"7/19/2024 5 a.m. PDT",785,802,90,-695
SCL,"7/19/2024 6 a.m. PDT",813,836,95,-718
SCL,"7/19/2024 7 a.m. PDT",892,906,185,-707
SCL,"7/19/2024 8 a.m. PDT",974,982,227,-747
SCL,"7/19/2024 9 a.m. PDT",1010,1029,236,-774
SCL,"7/19/2024 10 a.m. PDT",1063,1063,257,-806
SCL,"7/19/2024 11 a.m. PDT",1101,1083,240,-861
SCL,"7/19/2024 12 p.m. PDT",1136,1104,284,-852
SCL,"7/19/2024 1 p.m. PDT",1161,1120,436,-725
SCL,"7/19/2024 2 p.m. PDT",1178,1138,553,-625
SCL,"7/19/2024 3 p.m. PDT",1200,1153,508,-692
SCL,"7/19/2024 4 p.m. PDT",1232,1171,509,-723
SCL,"7/19/2024 5 p.m. PDT",1254,1196,610,-644
SCL,"7/19/2024 6 p.m. PDT",1267,1204,716,-551
SCL,"7/19/2024 7 p.m. PDT",1225,1163,686,-539
SCL,"7/19/2024 8 p.m. PDT",1187,1124,789,-398
SCL,"7/19/2024 9 p.m. PDT",1146,1089,674,-472
SCL,"7/19/2024 10 p.m. PDT",1118,1071,556,-562
SCL,"7/19/2024 11 p.m. PDT",1064,1020,369,-695
SCL,"7/20/2024 12 a.m. PDT",982,947,339,-643
SCL,"7/20/2024 1 a.m. PDT",916,893,130,-786
SCL,"7/20/2024 2 a.m. PDT",854,831,125,-729
SCL,"7/20/2024 3 a.m. PDT",825,797,94,-731
SCL,"7/20/2024 4 a.m. PDT",819,775,93,-726
SCL,"7/20/2024 5 a.m. PDT",815,771,93,-722
SCL,"7/20/2024 6 a.m. PDT",813,775,93,-720
SCL,"7/20/2024 7 a.m. PDT",831,805,149,-682
SCL,"7/20/2024 8 a.m. PDT",896,862,197,-699
SCL,"7/20/2024 9 a.m. PDT",959,923,233,-726
SCL,"7/20/2024 10 a.m. PDT",1009,966,365,-644
SCL,"7/20/2024 11 a.m. PDT",1050,1005,365,-685
SCL,"7/20/2024 12 p.m. PDT",1083,1030,369,-714
SCL,"7/20/2024 1 p.m. PDT",1108,1047,406,-702
SCL,"7/20/2024 2 p.m. PDT",1119,1056,403,-716
SCL,"7/20/2024 3 p.m. PDT",1136,1067,425,-711
SCL,"7/20/2024 4 p.m. PDT",1153,1085,503,-650
SCL,"7/20/2024 5 p.m. PDT",1173,1105,631,-542
SCL,"7/20/2024 6 p.m. PDT",1197,1131,787,-410
SCL,"7/20/2024 7 p.m. PDT",1196,1125,773,-423
SCL,"7/20/2024 8 p.m. PDT",1170,1105,842,-328
SCL,"7/20/2024 9 p.m. PDT",1133,1074,813,-320
SCL,"7/20/2024 10 p.m. PDT",1118,1060,716,-402
SCL,"7/20/2024 11 p.m. PDT",1085,1012,412,-673
SCL,"7/21/2024 12 a.m. PDT",1002,946,336,-666
SCL,"7/21/2024 1 a.m. PDT",916,906,283,-633
SCL,"7/21/2024 2 a.m. PDT",884,852,198,-686
SCL,"7/21/2024 3 a.m. PDT",849,815,188,-661
SCL,"7/21/2024 4 a.m. PDT",837,790,97,-740
SCL,"7/21/2024 5 a.m. PDT",818,775,125,-693
SCL,"7/21/2024 6 a.m. PDT",813,769,129,-684
SCL,"7/21/2024 7 a.m. PDT",823,789,130,-693
SCL,"7/21/2024 8 a.m. PDT",879,833,228,-651
SCL,"7/21/2024 9 a.m. PDT",907,885,227,-680
SCL,"7/21/2024 10 a.m. PDT",959,934,223,-736
SCL,"7/21/2024 11 a.m. PDT",998,969,306,-692
SCL,"7/21/2024 12 p.m. PDT",1017,992,333,-684
SCL,"7/21/2024 1 p.m. PDT",1031,1012,448,-583
SCL,"7/21/2024 2 p.m. PDT",1008,1031,430,-578
SCL,"7/21/2024 3 p.m. PDT",1029,1048,434,-595
SCL,"7/21/2024 4 p.m. PDT",1044,1070,412,-632
SCL,"7/21/2024 5 p.m. PDT",1089,1100,615,-474
SCL,"7/21/2024 6 p.m. PDT",1130,1131,610,-520
SCL,"7/21/2024 7 p.m. PDT",1145,1135,614,-531
SCL,"7/21/2024 8 p.m. PDT",1131,1121,789,-342
SCL,"7/21/2024 9 p.m. PDT",1099,1097,543,-556
SCL,"7/21/2024 10 p.m. PDT",1090,1086,544,-546
SCL,"7/21/2024 11 p.m. PDT",1032,1034,400,-632
SCL,"7/22/2024 12 a.m. PDT",950,947,329,-621
SCL,"7/22/2024 1 a.m. PDT",877,851,235,-642
SCL,"7/22/2024 2 a.m. PDT",831,806,195,-636
SCL,"7/22/2024 3 a.m. PDT",817,781,128,-689
SCL,"7/22/2024 4 a.m. PDT",802,771,130,-672
SCL,"7/22/2024 5 a.m. PDT",795,780,125,-670
SCL,"7/22/2024 6 a.m. PDT",862,815,136,-726
SCL,"7/22/2024 7 a.m. PDT",910,881,419,-491
SCL,"7/22/2024 8 a.m. PDT",992,953,420,-572
SCL,"7/22/2024 9 a.m. PDT",1035,995,401,-634
SCL,"7/22/2024 10 a.m. PDT",1050,1017,398,-652
SCL,"7/22/2024 11 a.m. PDT",1073,1031,380,-693
SCL,"7/22/2024 12 p.m. PDT",1073,1042,368,-705
SCL,"7/22/2024 1 p.m. PDT",1087,1053,420,-667
SCL,"7/22/2024 2 p.m. PDT",1075,1059,492,-583
SCL,"7/22/2024 3 p.m. PDT",1082,1065,620,-462
SCL,"7/22/2024 4 p.m. PDT",1070,1078,581,-489
SCL,"7/22/2024 5 p.m. PDT",1076,1095,700,-376
SCL,"7/22/2024 6 p.m. PDT",1079,1112,660,-419
SCL,"7/22/2024 7 p.m. PDT",1064,1083,855,-209
SCL,"7/22/2024 8 p.m. PDT",1046,1057,946,-100
SCL,"7/22/2024 9 p.m. PDT",1031,1033,753,-278
SCL,"7/22/2024 10 p.m. PDT",1013,1020,610,-403
SCL,"7/22/2024 11 p.m. PDT",948,958,264,-684
SCL,"7/23/2024 12 a.m. PDT",873,882,275,-598
SCL,"7/23/2024 1 a.m. PDT",820,788,195,-625
SCL,"7/23/2024 2 a.m. PDT",780,748,174,-606
SCL,"7/23/2024 3 a.m. PDT",763,726,149,-614
SCL,"7/23/2024 4 a.m. PDT",760,722,179,-581
SCL,"7/23/2024 5 a.m. PDT",776,741,195,-581
SCL,"7/23/2024 6 a.m. PDT",811,790,248,-563
SCL,"7/23/2024 7 a.m. PDT",863,877,459,-404
SCL,"7/23/2024 8 a.m. PDT",966,965,425,-541
SCL,"7/23/2024 9 a.m. PDT",1006,1010,376,-630
SCL,"7/23/2024 10 a.m. PDT",1027,1031,433,-594
SCL,"7/23/2024 11 a.m. PDT",1045,1041,423,-622
SCL,"7/23/2024 12 p.m. PDT",1061,1052,462,-599
SCL,"7/23/2024 1 p.m. PDT",1075,1065,571,-504
SCL,"7/23/2024 2 p.m. PDT",1070,1074,601,-469
SCL,"7/23/2024 3 p.m. PDT",1081,1079,602,-479
SCL,"7/23/2024 4 p.m. PDT",1090,1086,610,-480
SCL,"7/23/2024 5 p.m. PDT",1111,1101,850,-261
SCL,"7/23/2024 6 p.m. PDT",1138,1117,875,-263
SCL,"7/23/2024 7 p.m. PDT",1120,1092,1052,-68
SCL,"7/23/2024 8 p.m. PDT",1090,1067,1187,97
SCL,"7/23/2024 9 p.m. PDT",1060,1043,877,-183
SCL,"7/23/2024 10 p.m. PDT",1035,1029,841,-194
SCL,"7/23/2024 11 p.m. PDT",983,964,438,-545
SCL,"7/24/2024 12 a.m. PDT",899,886,388,-511
SCL,"7/24/2024 1 a.m. PDT",848,814,100,-748
SCL,"7/24/2024 2 a.m. PDT",775,771,95,-680
SCL,"7/24/2024 3 a.m. PDT",728,746,136,-592
SCL,"7/24/2024 4 a.m. PDT",720,737,138,-582
SCL,"7/24/2024 5 a.m. PDT",721,749,137,-584
SCL,"7/24/2024 6 a.m. PDT",763,790,198,-565
SCL,"7/24/2024 7 a.m. PDT",843,867,444,-399
SCL,"7/24/2024 8 a.m. PDT",915,945,435,-480
SCL,"7/24/2024 9 a.m. PDT",964,985,247,-717
SCL,"7/24/2024 10 a.m. PDT",982,999,265,-717
SCL,"7/24/2024 11 a.m. PDT",1005,1009,221,-784
SCL,"7/24/2024 12 p.m. PDT",1022,1018,245,-777
SCL,"7/24/2024 1 p.m. PDT",1033,1030,244,-789
SCL,"7/24/2024 2 p.m. PDT",1048,1041,245,-803
SCL,"7/24/2024 3 p.m. PDT",1057,1051,213,-844
SCL,"7/24/2024 4 p.m. PDT",1079,1066,283,-796
SCL,"7/24/2024 5 p.m. PDT",1097,1082,600,-497
SCL,"7/24/2024 6 p.m. PDT",1086,1095,689,-397
SCL,"7/24/2024 7 p.m. PDT",1060,1063,932,-128
SCL,"7/24/2024 8 p.m. PDT",1036,1032,841,-195
SCL,"7/24/2024 9 p.m. PDT",1000,1009,785,-215
SCL,"7/24/2024 10 p.m. PDT",985,996,801,-184
SCL,"7/24/2024 11 p.m. PDT",921,939,381,-540
SCL,"7/25/2024 12 a.m. PDT",844,863,284,-560
SCL,"7/25/2024 1 a.m. PDT",784,803,156,-628
SCL,"7/25/2024 2 a.m. PDT",741,755,158,-583
SCL,"7/25/2024 3 a.m. PDT",720,731,143,-577
SCL,"7/25/2024 4 a.m. PDT",713,722,139,-574
SCL,"7/25/2024 5 a.m. PDT",721,735,160,-561
SCL,"7/25/2024 6 a.m. PDT",766,778,200,-566
SCL,"7/25/2024 7 a.m. PDT",837,856,255,-582
SCL,"7/25/2024 8 a.m. PDT",911,935,245,-666
SCL,"7/25/2024 9 a.m. PDT",959,975,208,-751
SCL,"7/25/2024 10 a.m. PDT",976,992,246,-730
SCL,"7/25/2024 11 a.m. PDT",983,1001,266,-717
SCL,"7/25/2024 12 p.m. PDT",994,1008,243,-751
SCL,"7/25/2024 1 p.m. PDT",1005,1019,263,-742
SCL,"7/25/2024 2 p.m. PDT",1015,1026,445,-570
SCL,"7/25/2024 3 p.m. PDT",1022,1036,382,-640
SCL,"7/25/2024 4 p.m. PDT",1030,1047,423,-607
SCL,"7/25/2024 5 p.m. PDT",1036,1063,508,-528
SCL,"7/25/2024 6 p.m. PDT",1047,1076,657,-390
SCL,"7/25/2024 7 p.m. PDT",1022,1051,829,-193
SCL,"7/25/2024 8 p.m. PDT",1004,1026,825,-179
SCL,"7/25/2024 9 p.m. PDT",981,1006,737,-244
SCL,"7/25/2024 10 p.m. PDT",965,995,592,-373
SCL,"7/25/2024 11 p.m. PDT",909,934,365,-544
SCL,"7/26/2024 12 a.m. PDT",840,860,318,-522
SCL,"7/26/2024 1 a.m. PDT",776,795,199,-577
SCL,"7/26/2024 2 a.m. PDT",731,749,200,-531
SCL,"7/26/2024 3 a.m. PDT",712,725,201,-511
SCL,"7/26/2024 4 a.m. PDT",702,718,183,-519
SCL,"7/26/2024 5 a.m. PDT",716,733,184,-532
SCL,"7/26/2024 6 a.m. PDT",751,778,184,-567
SCL,"7/26/2024 7 a.m. PDT",821,860,486,-335
SCL,"7/26/2024 8 a.m. PDT",899,938,494,-405
SCL,"7/26/2024 9 a.m. PDT",974,981,624,-350
SCL,"7/26/2024 10 a.m. PDT",1003,1002,434,-569
SCL,"7/26/2024 11 a.m. PDT",1044,1011,416,-628
SCL,"7/26/2024 12 p.m. PDT",1062,1019,410,-652
SCL,"7/26/2024 1 p.m. PDT",1061,1028,411,-650
SCL,"7/26/2024 2 p.m. PDT",1079,1033,409,-670
SCL,"7/26/2024 3 p.m. PDT",1085,1042,377,-708
SCL,"7/26/2024 4 p.m. PDT",1097,1056,407,-690
SCL,"7/26/2024 5 p.m. PDT",1112,1075,409,-703
SCL,"7/26/2024 6 p.m. PDT",1123,1087,533,-590
SCL,"7/26/2024 7 p.m. PDT",1089,1053,643,-446
SCL,"7/26/2024 8 p.m. PDT",1060,1016,812,-248
SCL,"7/26/2024 9 p.m. PDT",1020,996,793,-227
SCL,"7/26/2024 10 p.m. PDT",1012,983,709,-303
SCL,"7/26/2024 11 p.m. PDT",965,931,345,-620
SCL,"7/27/2024 12 a.m. PDT",902,867,302,-600
SCL,"7/27/2024 1 a.m. PDT",847,816,199,-648
SCL,"7/27/2024 2 a.m. PDT",797,769,195,-602
SCL,"7/27/2024 3 a.m. PDT",774,739,197,-577
SCL,"7/27/2024 4 a.m. PDT",749,724,179,-570
SCL,"7/27/2024 5 a.m. PDT",743,725,177,-566
SCL,"7/27/2024 6 a.m. PDT",761,736,178,-583
SCL,"7/27/2024 7 a.m. PDT",771,767,254,-517
SCL,"7/27/2024 8 a.m. PDT",827,821,271,-556
SCL,"7/27/2024 9 a.m. PDT",880,876,237,-643
SCL,"7/27/2024 10 a.m. PDT",927,912,241,-686
SCL,"7/27/2024 11 a.m. PDT",952,936,248,-704
SCL,"7/27/2024 12 p.m. PDT",971,948,270,-701
SCL,"7/27/2024 1 p.m. PDT",999,956,404,-595
SCL,"7/27/2024 2 p.m. PDT",998,959,411,-587
SCL,"7/27/2024 3 p.m. PDT",1001,962,410,-591
SCL,"7/27/2024 4 p.m. PDT",1015,979,410,-605
SCL,"7/27/2024 5 p.m. PDT",1030,999,411,-619
SCL,"7/27/2024 6 p.m. PDT",1048,1027,409,-639
SCL,"7/27/2024 7 p.m. PDT",1065,1028,620,-445
SCL,"7/27/2024 8 p.m. PDT",1043,1019,624,-419
SCL,"7/27/2024 9 p.m. PDT",1024,1000,679,-345
SCL,"7/27/2024 10 p.m. PDT",1014,984,622,-392
SCL,"7/27/2024 11 p.m. PDT",966,931,400,-566
SCL,"7/28/2024 12 a.m. PDT",903,870,355,-548
SCL,"7/28/2024 1 a.m. PDT",845,818,284,-561
SCL,"7/28/2024 2 a.m. PDT",805,776,286,-519
SCL,"7/28/2024 3 a.m. PDT",770,745,217,-553
SCL,"7/28/2024 4 a.m. PDT",749,727,202,-547
SCL,"7/28/2024 5 a.m. PDT",737,722,205,-532
SCL,"7/28/2024 6 a.m. PDT",745,726,204,-541
SCL,"7/28/2024 7 a.m. PDT",764,748,247,-517
SCL,"7/28/2024 8 a.m. PDT",791,792,220,-571
SCL,"7/28/2024 9 a.m. PDT",856,837,108,-748
SCL,"7/28/2024 10 a.m. PDT",901,875,139,-762
SCL,"7/28/2024 11 a.m. PDT",928,902,108,-820
SCL,"7/28/2024 12 p.m. PDT",949,918,141,-808
SCL,"7/28/2024 1 p.m. PDT",956,933,236,-720
SCL,"7/28/2024 2 p.m. PDT",958,939,239,-719
SCL,"7/28/2024 3 p.m. PDT",942,947,238,-704
SCL,"7/28/2024 4 p.m. PDT",962,964,243,-719
SCL,"7/28/2024 5 p.m. PDT",982,994,244,-738
SCL,"7/28/2024 6 p.m. PDT",1005,1025,389,-616
SCL,"7/28/2024 7 p.m. PDT",1032,1039,630,-402
SCL,"7/28/2024 8 p.m. PDT",1038,1033,625,-413
SCL,"7/28/2024 9 p.m. PDT",1003,1019,486,-517
SCL,"7/28/2024 10 p.m. PDT",1010,1010,458,-552
SCL,"7/28/2024 11 p.m. PDT",963,948,418,-545
SCL,"7/29/2024 12 a.m. PDT",885,868,327,-559
SCL,"7/29/2024 1 a.m. PDT",819,803,204,-615
SCL,"7/29/2024 2 a.m. PDT",785,756,211,-574
SCL,"7/29/2024 3 a.m. PDT",772,736,214,-558
SCL,"7/29/2024 4 a.m. PDT",763,731,212,-551
SCL,"7/29/2024 5 a.m. PDT",784,744,218,-566
SCL,"7/29/2024 6 a.m. PDT",830,788,223,-607
SCL,"7/29/2024 7 a.m. PDT",860,861,513,-347
SCL,"7/29/2024 8 a.m. PDT",933,935,518,-415
SCL,"7/29/2024 9 a.m. PDT",983,971,432,-551
SCL,"7/29/2024 10 a.m. PDT",1008,988,409,-599
SCL,"7/29/2024 11 a.m. PDT",1035,996,385,-650
SCL,"7/29/2024 12 p.m. PDT",1098,1002,425,-673
SCL,"7/29/2024 1 p.m. PDT",1104,1009,468,-636
SCL,"7/29/2024 2 p.m. PDT",1104,1007,483,-621
SCL,"7/29/2024 3 p.m. PDT",1107,1004,467,-640
SCL,"7/29/2024 4 p.m. PDT",1098,1007,413,-685
SCL,"7/29/2024 5 p.m. PDT",1093,1026,422,-671
SCL,"7/29/2024 6 p.m. PDT",1088,1045,541,-547
SCL,"7/29/2024 7 p.m. PDT",1079,1028,609,-470
SCL,"7/29/2024 8 p.m. PDT",1059,1011,634,-425
SCL,"7/29/2024 9 p.m. PDT",1050,997,632,-418
SCL,"7/29/2024 10 p.m. PDT",1034,984,499,-535
SCL,"7/29/2024 11 p.m. PDT",974,924,313,-661
SCL,"7/30/2024 12 a.m. PDT",904,850,281,-623
SCL,"7/30/2024 1 a.m. PDT",843,814,320,-523
SCL,"7/30/2024 2 a.m. PDT",815,779,244,-571
SCL,"7/30/2024 3 a.m. PDT",787,756,160,-627
SCL,"7/30/2024 4 a.m. PDT",788,747,209,-579
SCL,"7/30/2024 5 a.m. PDT",801,757,161,-640
SCL,"7/30/2024 6 a.m. PDT",849,802,158,-691
SCL,"7/30/2024 7 a.m. PDT",921,879,298,-623
SCL,"7/30/2024 8 a.m. PDT",999,954,345,-654
SCL,"7/30/2024 9 a.m. PDT",1041,988,287,-754
SCL,"7/30/2024 10 a.m. PDT",1077,1004,414,-663
SCL,"7/30/2024 11 a.m. PDT",1077,1010,423,-654
SCL,"7/30/2024 12 p.m. PDT",1110,1018,416,-694
SCL,"7/30/2024 1 p.m. PDT",1113,1029,414,-699
SCL,"7/30/2024 2 p.m. PDT",1124,1035,420,-704
SCL,"7/30/2024 3 p.m. PDT",1140,1040,417,-723
SCL,"7/30/2024 4 p.m. PDT",1143,1050,582,-561
SCL,"7/30/2024 5 p.m. PDT",1158,1067,583,-575
SCL,"7/30/2024 6 p.m. PDT",1158,1077,588,-570
SCL,"7/30/2024 7 p.m. PDT",1136,1066,667,-469
SCL,"7/30/2024 8 p.m. PDT",1113,1037,670,-443
SCL,"7/30/2024 9 p.m. PDT",1092,1021,677,-415
SCL,"7/30/2024 10 p.m. PDT",1081,1011,512,-569
SCL,"7/30/2024 11 p.m. PDT",1018,946,301,-717
SCL,"7/31/2024 12 a.m. PDT",940,867,303,-637
SCL,"7/31/2024 1 a.m. PDT",874,846,280,-594
SCL,"7/31/2024 2 a.m. PDT",830,803,245,-585
SCL,"7/31/2024 3 a.m. PDT",810,777,273,-537
SCL,"7/31/2024 4 a.m. PDT",793,767,255,-538
SCL,"7/31/2024 5 a.m. PDT",786,777,260,-526
SCL,"7/31/2024 6 a.m. PDT",808,822,296,-512
SCL,"7/31/2024 7 a.m. PDT",881,898,413,-468
SCL,"7/31/2024 8 a.m. PDT",953,975,305,-648
SCL,"7/31/2024 9 a.m. PDT",1004,1016,416,-588
SCL,"7/31/2024 10 a.m. PDT",1025,1036,414,-611
SCL,"7/31/2024 11 a.m. PDT",1046,1051,416,-630
SCL,"7/31/2024 12 p.m. PDT",1064,1064,418,-646
SCL,"7/31/2024 1 p.m. PDT",1084,1080,421,-663
SCL,"7/31/2024 2 p.m. PDT",1108,1095,418,-690
SCL,"7/31/2024 3 p.m. PDT",1120,1111,421,-699
SCL,"7/31/2024 4 p.m. PDT",1135,1129,427,-708
SCL,"7/31/2024 5 p.m. PDT",1161,1149,443,-718
SCL,"7/31/2024 6 p.m. PDT",1169,1160,620,-549
SCL,"7/31/2024 7 p.m. PDT",1149,1133,821,-328
SCL,"7/31/2024 8 p.m. PDT",1115,1105,839,-276
SCL,"7/31/2024 9 p.m. PDT",1077,1079,802,-275
SCL,"7/31/2024 10 p.m. PDT",1051,1061,654,-397
SCL,"7/31/2024 11 p.m. PDT",979,991,460,-519