"BA Code","Timestamp (Hour Ending)","Demand (MWh)","Demand Forecast (MWh)","Net Generation (MWh)","Total Interchange (MWh)"
SCL,"9/1/2024 12 a.m. PDT",962,889,289,-673
SCL,"9/1/2024 1 a.m. PDT",858,859,210,-648
SCL,"9/1/2024 2 a.m. PDT",852,815,203,-649
SCL,"9/1/2024 3 a.m. PDT",816,785,197,-619
SCL,"9/1/2024 4 a.m. PDT",800,766,196,-604
SCL,"9/1/2024 5 a.m. PDT",800,760,205,-595
SCL,"9/1/2024 6 a.m. PDT",796,766,201,-595
SCL,"9/1/2024 7 a.m. PDT",819,786,331,-488
SCL,"9/1/2024 8 a.m. PDT",850,818,325,-525
SCL,"9/1/2024 9 a.m. PDT",914,877,299,-615
SCL,"9/1/2024 10 a.m. PDT",956,928,301,-655
SCL,"9/1/2024 11 a.m. PDT",1006,970,308,-698
SCL,"9/1/2024 12 p.m. PDT",1040,997,312,-728
SCL,"9/1/2024 1 p.m. PDT",1058,1016,312,-746
SCL,"9/1/2024 2 p.m. PDT",1077,1034,342,-735
SCL,"9/1/2024 3 p.m. PDT",1053,1049,344,-709
SCL,"9/1/2024 4 p.m. PDT",1075,1059,332,-743
SCL,"9/1/2024 5 p.m. PDT",1145,1084,341,-804
SCL,"9/1/2024 6 p.m. PDT",1157,1099,631,-526
SCL,"9/1/2024 7 p.m. PDT",1159,1097,633,-526
SCL,"9/1/2024 8 p.m. PDT",1119,1088,619,-500
SCL,"9/1/2024 9 p.m. PDT",1111,1084,550,-561
SCL,"9/1/2024 10 p.m. PDT",1068,1042,504,-564
SCL,"9/1/2024 11 p.m. PDT",990,984,275,-715
SCL,"9/2/2024 12 a.m. PDT",935,904,266,-669
SCL,"9/2/2024 1 a.m. PDT",871,824,177,-694
SCL,"9/2/2024 2 a.m. PDT",838,794,159,-679
SCL,"9/2/2024 3 a.m. PDT",810,768,160,-650
SCL,"9/2/2024 4 a.m. PDT",798,755,157,-641
SCL,"9/2/2024 5 a.m. PDT",800,756,156,-644
SCL,"9/2/2024 6 a.m. PDT",827,777,163,-664
SCL,"9/2/2024 7 a.m. PDT",850,807,283,-567
SCL,"9/2/2024 8 a.m. PDT",887,834,284,-603
SCL,"9/2/2024 9 a.m. PDT",925,874,268,-657
SCL,"9/2/2024 10 a.m. PDT",971,911,273,-698
SCL,"9/2/2024 11 a.m. PDT",1001,947,273,-728
SCL,"9/2/2024 12 p.m. PDT",1029,968,254,-775
SCL,"9/2/2024 1 p.m. PDT",1038,984,278,-760
SCL,"9/2/2024 2 p.m. PDT",1035,991,270,-765
SCL,"9/2/2024 3 p.m. PDT",1047,1006,283,-764
SCL,"9/2/2024 4 p.m. PDT",1058,1026,281,-777
SCL,"9/2/2024 5 p.m. PDT",1074,1047,388,-686
SCL,"9/2/2024 6 p.m. PDT",1075,1051,514,-561
SCL,"9/2/2024 7 p.m. PDT",1080,1039,563,-517
SCL,"9/2/2024 8 p.m. PDT",1063,1028,567,-496
SCL,"9/2/2024 9 p.m. PDT",1011,1036,414,-597
SCL,"9/2/2024 10 p.m. PDT",972,991,402,-570
SCL,"9/2/2024 11 p.m. PDT",900,927,284,-616
SCL,"9/3/2024 12 a.m. PDT",839,860,268,-571
SCL,"9/3/2024 1 a.m. PDT",775,790,241,-534
SCL,"9/3/2024 2 a.m. PDT",744,758,200,-544
SCL,"9/3/2024 3 a.m. PDT",729,739,116,-613
SCL,"9/3/2024 4 a.m. PDT",718,734,115,-603
SCL,"9/3/2024 5 a.m. PDT",737,753,136,-601
SCL,"9/3/2024 6 a.m. PDT",779,808,220,-559
SCL,"9/3/2024 7 a.m. PDT",877,902,392,-485
SCL,"9/3/2024 8 a.m. PDT",947,978,368,-579
SCL,"9/3/2024 9 a.m. PDT",1010,1009,322,-688
SCL,"9/3/2024 10 a.m. PDT",1066,1024,308,-758
SCL,"9/3/2024 11 a.m. PDT",1078,1032,454,-624
SCL,"9/3/2024 12 p.m. PDT",1100,1043,355,-745
SCL,"9/3/2024 1 p.m. PDT",1109,1056,426,-683
SCL,"9/3/2024 2 p.m. PDT",197,1066,447,250
SCL,"9/3/2024 3 p.m. PDT",1114,1069,341,-773
SCL,"9/3/2024 4 p.m. PDT",1125,1076,337,-788
SCL,"9/3/2024 5 p.m. PDT",1145,1094,606,-539
SCL,"9/3/2024 6 p.m. PDT",1154,1095,617,-537
SCL,"9/3/2024 7 p.m. PDT",1123,1067,659,-464
SCL,"9/3/2024 8 p.m. PDT",1116,1052,567,-549
SCL,"9/3/2024 9 p.m. PDT",1107,1050,457,-650
SCL,"9/3/2024 10 p.m. PDT",1050,1002,470,-580
SCL,"9/3/2024 11 p.m. PDT",982,929,212,-770
SCL,"9/4/2024 12 a.m. PDT",904,855,168,-736
SCL,"9/4/2024 1 a.m. PDT",845,807,244,-601
SCL,"9/4/2024 2 a.m. PDT",802,771,210,-592
SCL,"9/4/2024 3 a.m. PDT",774,750,165,-609
SCL,"9/4/2024 4 a.m. PDT",774,743,134,-640
SCL,"9/4/2024 5 a.m. PDT",732,759,131,-601
SCL,"9/4/2024 6 a.m. PDT",782,814,195,-587
SCL,"9/4/2024 7 a.m. PDT",877,906,314,-563
SCL,"9/4/2024 8 a.m. PDT",943,980,301,-642
SCL,"9/4/2024 9 a.m. PDT",972,1011,301,-671
SCL,"9/4/2024 10 a.m. PDT",998,1025,223,-775
SCL,"9/4/2024 11 a.m. PDT",1026,1036,270,-756
SCL,"9/4/2024 12 p.m. PDT",1041,1049,248,-793
SCL,"9/4/2024 1 p.m. PDT",1067,1063,293,-774
SCL,"9/4/2024 2 p.m. PDT",1087,1077,306,-781
SCL,"9/4/2024 3 p.m. PDT",1108,1087,305,-803
SCL,"9/4/2024 4 p.m. PDT",1126,1101,370,-756
SCL,"9/4/2024 5 p.m. PDT",1156,1126,451,-705
SCL,"9/4/2024 6 p.m. PDT",1165,1127,417,-748
SCL,"9/4/2024 7 p.m. PDT",1135,1096,766,-369
SCL,"9/4/2024 8 p.m. PDT",1105,1071,743,-362
SCL,"9/4/2024 9 p.m. PDT",1087,1064,690,-397
SCL,"9/4/2024 10 p.m. PDT",1033,1016,434,-599
SCL,"9/4/2024 11 p.m. PDT",958,944,316,-642
SCL,"9/5/2024 12 a.m. PDT",890,869,204,-686
SCL,"9/5/2024 1 a.m. PDT",824,828,205,-619
SCL,"9/5/2024 2 a.m. PDT",777,791,174,-603
SCL,"9/5/2024 3 a.m. PDT",753,768,122,-631
SCL,"9/5/2024 4 a.m. PDT",739,759,115,-624
SCL,"9/5/2024 5 a.m. PDT",748,774,120,-628
SCL,"9/5/2024 6 a.m. PDT",801,827,174,-627
SCL,"9/5/2024 7 a.m. PDT",889,921,288,-601
SCL,"9/5/2024 8 a.m. PDT",971,998,314,-657
SCL,"9/5/2024 9 a.m. PDT",1020,1033,312,-708
SCL,"9/5/2024 10 a.m. PDT",1065,1057,487,-578
SCL,"9/5/2024 11 a.m. PDT",1093,1078,482,-611
SCL,"9/5/2024 12 p.m. PDT",1120,1104,485,-635
SCL,"9/5/2024 1 p.m. PDT",1157,1127,516,-641
SCL,"9/5/2024 2 p.m. PDT",1188,1151,531,-657
SCL,"9/5/2024 3 p.m. PDT",1218,1167,581,-637
SCL,"9/5/2024 4 p.m. PDT",1241,1184,503,-738
SCL,"9/5/2024 5 p.m. PDT",1274,1218,639,-635
SCL,"9/5/2024 6 p.m. PDT",1286,1215,887,-399
SCL,"9/5/2024 7 p.m. PDT",1240,1181,933,-307
SCL,"9/5/2024 8 p.m. PDT",1209,1148,881,-328
SCL,"9/5/2024 9 p.m. PDT",1181,1128,766,-415
SCL,"9/5/2024 10 p.m. PDT",1121,1077,813,-308
SCL,"9/5/2024 11 p.m. PDT",1038,1001,432,-606
SCL,"9/6/2024 12 a.m. PDT",955,923,329,-626
SCL,"9/6/2024 1 a.m. PDT",888,890,227,-661
SCL,"9/6/2024 2 a.m. PDT",834,851,125,-709
SCL,"9/6/2024 3 a.m. PDT",803,822,148,-655
SCL,"9/6/2024 4 a.m. PDT",783,807,117,-666
SCL,"9/6/2024 5 a.m. PDT",795,813,147,-648
SCL,"9/6/2024 6 a.m. PDT",852,856,156,-696
SCL,"9/6/2024 7 a.m. PDT",929,939,292,-637
SCL,"9/6/2024 8 a.m. PDT",1015,1007,630,-385
SCL,"9/6/2024 9 a.m. PDT",1080,1040,713,-367
SCL,"9/6/2024 10 a.m. PDT",1151,1072,558,-593
SCL,"9/6/2024 11 a.m. PDT",1186,1097,627,-559
SCL,"9/6/2024 12 p.m. PDT",1191,1122,633,-558
SCL,"9/6/2024 1 p.m. PDT",1195,1145,662,-533
SCL,"9/6/2024 2 p.m. PDT",1225,1172,673,-552
SCL,"9/6/2024 3 p.m. PDT",1300,1188,677,-623
SCL,"9/6/2024 4 p.m. PDT",1313,1206,799,-514
SCL,"9/6/2024 5 p.m. PDT",1342,1232,800,-542
SCL,"9/6/2024 6 p.m. PDT",1332,1214,943,-389
SCL,"9/6/2024 7 p.m. PDT",1268,1161,950,-318
SCL,"9/6/2024 8 p.m. PDT",1216,1115,840,-376
SCL,"9/6/2024 9 p.m. PDT",1183,1094,651,-532
SCL,"9/6/2024 10 p.m. PDT",1085,1051,643,-442
SCL,"9/6/2024 11 p.m. PDT",1017,996,274,-743
SCL,"9/7/2024 12 a.m. PDT",975,936,276,-699
SCL,"9/7/2024 1 a.m. PDT",933,900,218,-715
SCL,"9/7/2024 2 a.m. PDT",883,854,201,-682
SCL,"9/7/2024 3 a.m. PDT",852,821,161,-691
SCL,"9/7/2024 4 a.m. PDT",828,799,148,-680
SCL,"9/7/2024 5 a.m. PDT",830,790,117,-713
SCL,"9/7/2024 6 a.m. PDT",839,799,150,-689
SCL,"9/7/2024 7 a.m. PDT",833,825,292,-541
SCL,"9/7/2024 8 a.m. PDT",903,865,301,-602
SCL,"9/7/2024 9 a.m. PDT",959,921,298,-661
SCL,"9/7/2024 10 a.m. PDT",1011,968,364,-647
SCL,"9/7/2024 11 a.m. PDT",1053,1002,379,-674
SCL,"9/7/2024 12 p.m. PDT",1074,1030,394,-680
SCL,"9/7/2024 1 p.m. PDT",1097,1048,421,-676
SCL,"9/7/2024 2 p.m. PDT",1100,1064,455,-645
SCL,"9/7/2024 3 p.m. PDT",1081,1073,454,-627
SCL,"9/7/2024 4 p.m. PDT",1067,1085,442,-625
SCL,"9/7/2024 5 p.m. PDT",1087,1097,585,-502
SCL,"9/7/2024 6 p.m. PDT",1095,1093,840,-255
SCL,"9/7/2024 7 p.m. PDT",1082,1089,857,-225
SCL,"9/7/2024 8 p.m. PDT",1081,1073,856,-225
SCL,"9/7/2024 9 p.m. PDT",1084,1065,740,-344
SCL,"9/7/2024 10 p.m. PDT",1042,1031,507,-535
SCL,"9/7/2024 11 p.m. PDT",994,987,369,-625
SCL,"9/8/2024 12 a.m. PDT",931,931,326,-605
SCL,"9/8/2024 1 a.m. PDT",889,853,248,-641
SCL,"9/8/2024 2 a.m. PDT",858,813,198,-660
SCL,"9/8/2024 3 a.m. PDT",819,785,193,-626
SCL,"9/8/2024 4 a.m. PDT",802,767,152,-650
SCL,"9/8/2024 5 a.m. PDT",774,760,148,-626
SCL,"9/8/2024 6 a.m. PDT",804,768,154,-650
SCL,"9/8/2024 7 a.m. PDT",818,788,250,-568
SCL,"9/8/2024 8 a.m. PDT",852,820,201,-651
SCL,"9/8/2024 9 a.m. PDT",898,875,300,-598
SCL,"9/8/2024 10 a.m. PDT",946,924,307,-639
SCL,"9/8/2024 11 a.m. PDT",981,959,308,-673
SCL,"9/8/2024 12 p.m. PDT",990,982,307,-683
SCL,"9/8/2024 1 p.m. PDT",1008,997,308,-700
SCL,"9/8/2024 2 p.m. PDT",1014,1011,312,-702
SCL,"9/8/2024 3 p.m. PDT",1030,1027,497,-533
SCL,"9/8/2024 4 p.m. PDT",1044,1035,501,-543
SCL,"9/8/2024 5 p.m. PDT",1090,1059,713,-377
SCL,"9/8/2024 6 p.m. PDT",1132,1077,749,-383
SCL,"9/8/2024 7 p.m. PDT",1131,1075,799,-332
SCL,"9/8/2024 8 p.m. PDT",1130,1069,793,-337
SCL,"9/8/2024 9 p.m. PDT",1104,1053,745,-359
SCL,"9/8/2024 10 p.m. PDT",1038,1012,492,-546
SCL,"9/8/2024 11 p.m. PDT",973,955,407,-566
SCL,"9/9/2024 12 a.m. PDT",907,890,208,-699
SCL,"9/9/2024 1 a.m. PDT",844,812,94,-750
SCL,"9/9/2024 2 a.m. PDT",806,778,93,-713
SCL,"9/9/2024 3 a.m. PDT",788,759,95,-693
SCL,"9/9/2024 4 a.m. PDT",757,755,92,-665
SCL,"9/9/2024 5 a.m. PDT",796,770,97,-699
SCL,"9/9/2024 6 a.m. PDT",849,824,195,-654
SCL,"9/9/2024 7 a.m. PDT",899,911,205,-694
SCL,"9/9/2024 8 a.m. PDT",973,979,240,-733
SCL,"9/9/2024 9 a.m. PDT",1054,1005,367,-687
SCL,"9/9/2024 10 a.m. PDT",1065,1019,430,-635
SCL,"9/9/2024 11 a.m. PDT",1060,1027,429,-631
SCL,"9/9/2024 12 p.m. PDT",1086,1037,425,-661
SCL,"9/9/2024 1 p.m. PDT",1094,1050,425,-669
SCL,"9/9/2024 2 p.m. PDT",1089,1057,423,-666
SCL,"9/9/2024 3 p.m. PDT",1093,1061,428,-665
SCL,"9/9/2024 4 p.m. PDT",1106,1068,593,-513
SCL,"9/9/2024 5 p.m. PDT",1129,1082,606,-523
SCL,"9/9/2024 6 p.m. PDT",1141,1086,608,-533
SCL,"9/9/2024 7 p.m. PDT",1083,1063,616,-467
SCL,"9/9/2024 8 p.m. PDT",1101,1049,596,-505
SCL,"9/9/2024 9 p.m. PDT",1100,1043,592,-508
SCL,"9/9/2024 10 p.m. PDT",1043,992,420,-623
SCL,"9/9/2024 11 p.m. PDT",973,923,249,-724
SCL,"9/10/2024 12 a.m. PDT",900,849,150,-750
SCL,"9/10/2024 1 a.m. PDT",836,808,147,-689
SCL,"9/10/2024 2 a.m. PDT",803,774,142,-661
SCL,"9/10/2024 3 a.m. PDT",782,754,138,-644
SCL,"9/10/2024 4 a.m. PDT",765,748,121,-644
SCL,"9/10/2024 5 a.m. PDT",745,762,122,-623
SCL,"9/10/2024 6 a.m. PDT",792,816,279,-513
SCL,"9/10/2024 7 a.m. PDT",886,910,476,-410
SCL,"9/10/2024 8 a.m. PDT",995,983,483,-512
SCL,"9/10/2024 9 a.m. PDT",1029,1008,398,-631
SCL,"9/10/2024 10 a.m. PDT",1043,1021,400,-643
SCL,"9/10/2024 11 a.m. PDT",1064,1027,401,-663
SCL,"9/10/2024 12 p.m. PDT",1062,1034,401,-661
SCL,"9/10/2024 1 p.m. PDT",1077,1041,395,-682
SCL,"9/10/2024 2 p.m. PDT",1093,1048,402,-691
SCL,"9/10/2024 3 p.m. PDT",1089,1046,407,-682
SCL,"9/10/2024 4 p.m. PDT",1105,1050,498,-607
SCL,"9/10/2024 5 p.m. PDT",1110,1063,503,-607
SCL,"9/10/2024 6 p.m. PDT",1109,1067,589,-520
SCL,"9/10/2024 7 p.m. PDT",1074,1048,622,-452
SCL,"9/10/2024 8 p.m. PDT",1056,1043,597,-459
SCL,"9/10/2024 9 p.m. PDT",1054,1033,485,-569
SCL,"9/10/2024 10 p.m. PDT",1007,985,369,-638
SCL,"9/10/2024 11 p.m. PDT",934,915,100,-834
SCL,"9/11/2024 12 a.m. PDT",865,844,99,-766
SCL,"9/11/2024 1 a.m. PDT",810,774,118,-692
SCL,"9/11/2024 2 a.m. PDT",779,745,111,-668
SCL,"9/11/2024 3 a.m. PDT",756,727,121,-635
SCL,"9/11/2024 4 a.m. PDT",752,722,110,-642
SCL,"9/11/2024 5 a.m. PDT",715,739,104,-611
SCL,"9/11/2024 6 a.m. PDT",775,796,153,-622
SCL,"9/11/2024 7 a.m. PDT",872,891,330,-542
SCL,"9/11/2024 8 a.m. PDT",944,967,332,-612
SCL,"9/11/2024 9 a.m. PDT",981,996,225,-756
SCL,"9/11/2024 10 a.m. PDT",1003,1009,225,-778
SCL,"9/11/2024 11 a.m. PDT",1003,1016,257,-746
SCL,"9/11/2024 12 p.m. PDT",1015,1021,256,-759
SCL,"9/11/2024 1 p.m. PDT",1020,1027,394,-626
SCL,"9/11/2024 2 p.m. PDT",1013,1032,401,-612
SCL,"9/11/2024 3 p.m. PDT",1019,1026,399,-620
SCL,"9/11/2024 4 p.m. PDT",1026,1030,397,-629
SCL,"9/11/2024 5 p.m. PDT",1011,1047,540,-471
SCL,"9/11/2024 6 p.m. PDT",1033,1050,550,-483
SCL,"9/11/2024 7 p.m. PDT",1018,1032,549,-469
SCL,"9/11/2024 8 p.m. PDT",1010,1031,544,-466
SCL,"9/11/2024 9 p.m. PDT",998,1025,448,-550
SCL,"9/11/2024 10 p.m. PDT",947,978,392,-555
SCL,"9/11/2024 11 p.m. PDT",879,909,222,-657
SCL,"9/12/2024 12 a.m. PDT",803,838,106,-697
SCL,"9/12/2024 1 a.m. PDT",756,768,100,-656
SCL,"9/12/2024 2 a.m. PDT",724,735,98,-626
SCL,"9/12/2024 3 a.m. PDT",702,717,100,-602
SCL,"9/12/2024 4 a.m. PDT",698,713,120,-578
SCL,"9/12/2024 5 a.m. PDT",714,729,135,-579
SCL,"9/12/2024 6 a.m. PDT",764,786,191,-573
SCL,"9/12/2024 7 a.m. PDT",858,884,311,-547
SCL,"9/12/2024 8 a.m. PDT",944,960,308,-636
SCL,"9/12/2024 9 a.m. PDT",975,989,387,-588
SCL,"9/12/2024 10 a.m. PDT",994,1004,259,-735
SCL,"9/12/2024 11 a.m. PDT",1002,1012,257,-745
SCL,"9/12/2024 12 p.m. PDT",1002,1019,257,-745
SCL,"9/12/2024 1 p.m. PDT",1020,1023,398,-622
SCL,"9/12/2024 2 p.m. PDT",1033,1027,399,-634
SCL,"9/12/2024 3 p.m. PDT",1016,1023,388,-628
SCL,"9/12/2024 4 p.m. PDT",1020,1026,401,-619
SCL,"9/12/2024 5 p.m. PDT",1019,1041,415,-604
SCL,"9/12/2024 6 p.m. PDT",1032,1050,427,-605
SCL,"9/12/2024 7 p.m. PDT",1015,1031,509,-506
SCL,"9/12/2024 8 p.m. PDT",1012,1027,514,-498
SCL,"9/12/2024 9 p.m. PDT",1002,1017,544,-458
SCL,"9/12/2024 10 p.m. PDT",960,970,450,-510
SCL,"9/12/2024 11 p.m. PDT",888,905,272,-616
SCL,"9/13/2024 12 a.m. PDT",819,837,237,-582
SCL,"9/13/2024 1 a.m. PDT",764,781,132,-632
SCL,"9/13/2024 2 a.m. PDT",724,742,118,-606
SCL,"9/13/2024 3 a.m. PDT",708,723,117,-591
SCL,"9/13/2024 4 a.m. PDT",695,717,110,-585
SCL,"9/13/2024 5 a.m. PDT",712,734,113,-599
SCL,"9/13/2024 6 a.m. PDT",760,790,150,-610
SCL,"9/13/2024 7 a.m. PDT",852,887,400,-452
SCL,"9/13/2024 8 a.m. PDT",927,958,548,-379
SCL,"9/13/2024 9 a.m. PDT",961,985,531,-430
SCL,"9/13/2024 10 a.m. PDT",977,994,562,-415
SCL,"9/13/2024 11 a.m. PDT",983,996,419,-564
SCL,"9/13/2024 12 p.m. PDT",983,997,428,-555
SCL,"9/13/2024 1 p.m. PDT",1000,998,442,-558
SCL,"9/13/2024 2 p.m. PDT",1019,999,467,-552
SCL,"9/13/2024 3 p.m. PDT",1050,995,570,-480
SCL,"9/13/2024 4 p.m. PDT",1053,997,670,-383
SCL,"9/13/2024 5 p.m. PDT",1057,1008,665,-392
SCL,"9/13/2024 6 p.m. PDT",1055,1006,706,-349
SCL,"9/13/2024 7 p.m. PDT",1032,984,850,-182
SCL,"9/13/2024 8 p.m. PDT",1023,970,816,-207
SCL,"9/13/2024 9 p.m. PDT",997,962,589,-408
SCL,"9/13/2024 10 p.m. PDT",962,923,589,-373
SCL,"9/13/2024 11 p.m. PDT",911,874,299,-612
SCL,"9/14/2024 12 a.m. PDT",861,822,287,-574
SCL,"9/14/2024 1 a.m. PDT",820,781,145,-675
SCL,"9/14/2024 2 a.m. PDT",779,751,107,-672
SCL,"9/14/2024 3 a.m. PDT",765,729,99,-666
SCL,"9/14/2024 4 a.m. PDT",755,716,100,-655
SCL,"9/14/2024 5 a.m. PDT",747,715,101,-646
SCL,"9/14/2024 6 a.m. PDT",768,735,133,-635
SCL,"9/14/2024 7 a.m. PDT",805,766,267,-538
SCL,"9/14/2024 8 a.m. PDT",853,807,245,-608
SCL,"9/14/2024 9 a.m. PDT",918,854,221,-697
SCL,"9/14/2024 10 a.m. PDT",958,892,210,-748
SCL,"9/14/2024 11 a.m. PDT",985,913,278,-707
SCL,"9/14/2024 12 p.m. PDT",996,924,481,-515
SCL,"9/14/2024 1 p.m. PDT",1000,923,315,-685
SCL,"9/14/2024 2 p.m. PDT",985,921,360,-625
SCL,"9/14/2024 3 p.m. PDT",959,917,214,-745
SCL,"9/14/2024 4 p.m. PDT",934,917,206,-728
SCL,"9/14/2024 5 p.m. PDT",936,926,257,-679
SCL,"9/14/2024 6 p.m. PDT",982,931,397,-585
SCL,"9/14/2024 7 p.m. PDT",971,933,746,-225
SCL,"9/14/2024 8 p.m. PDT",990,942,728,-262
SCL,"9/14/2024 9 p.m. PDT",986,943,541,-445
SCL,"9/14/2024 10 p.m. PDT",952,912,444,-508
SCL,"9/14/2024 11 p.m. PDT",908,867,297,-611
SCL,"9/15/2024 12 a.m. PDT",861,820,128,-733
SCL,"9/15/2024 1 a.m. PDT",818,785,149,-669
SCL,"9/15/2024 2 a.m. PDT",778,747,98,-680
SCL,"9/15/2024 3 a.m. PDT",759,726,101,-658
SCL,"9/15/2024 4 a.m. PDT",749,714,103,-646
SCL,"9/15/2024 5 a.m. PDT",746,713,101,-645
SCL,"9/15/2024 6 a.m. PDT",756,734,104,-652
SCL,"9/15/2024 7 a.m. PDT",789,767,141,-648
SCL,"9/15/2024 8 a.m. PDT",836,800,105,-731
SCL,"9/15/2024 9 a.m. PDT",887,849,94,-793
SCL,"9/15/2024 10 a.m. PDT",927,888,95,-832
SCL,"9/15/2024 11 a.m. PDT",972,911,92,-880
SCL,"9/15/2024 12 p.m. PDT",981,925,114,-867
SCL,"9/15/2024 1 p.m. PDT",978,929,120,-858
SCL,"9/15/2024 2 p.m. PDT",970,931,131,-839
SCL,"9/15/2024 3 p.m. PDT",966,931,116,-850
SCL,"9/15/2024 4 p.m. PDT",948,928,146,-802
SCL,"9/15/2024 5 p.m. PDT",930,943,258,-672
SCL,"9/15/2024 6 p.m. PDT",986,965,473,-513
SCL,"9/15/2024 7 p.m. PDT",1019,976,768,-251
SCL,"9/15/2024 8 p.m. PDT",1019,988,749,-270
SCL,"9/15/2024 9 p.m. PDT",986,983,489,-497
SCL,"9/15/2024 10 p.m. PDT",989,941,416,-573
SCL,"9/15/2024 11 p.m. PDT",923,879,253,-670
SCL,"9/16/2024 12 a.m. PDT",854,816,248,-606
SCL,"9/16/2024 1 a.m. PDT",805,775,184,-621
SCL,"9/16/2024 2 a.m. PDT",771,743,101,-670
SCL,"9/16/2024 3 a.m. PDT",760,729,96,-664
SCL,"9/16/2024 4 a.m. PDT",756,728,100,-656
SCL,"9/16/2024 5 a.m. PDT",774,747,124,-650
SCL,"9/16/2024 6 a.m. PDT",836,808,229,-607
SCL,"9/16/2024 7 a.m. PDT",939,914,425,-514
SCL,"9/16/2024 8 a.m. PDT",1009,987,516,-493
SCL,"9/16/2024 9 a.m. PDT",1013,1000,522,-491
SCL,"9/16/2024 10 a.m. PDT",1057,1006,481,-576
SCL,"9/16/2024 11 a.m. PDT",1073,1008,482,-591
SCL,"9/16/2024 12 p.m. PDT",1056,1014,475,-581
SCL,"9/16/2024 1 p.m. PDT",1015,1020,479,-536
SCL,"9/16/2024 2 p.m. PDT",1040,1021,475,-565
SCL,"9/16/2024 3 p.m. PDT",1006,1016,474,-532
SCL,"9/16/2024 4 p.m. PDT",1054,1023,527,-527
SCL,"9/16/2024 5 p.m. PDT",1060,1041,588,-472
SCL,"9/16/2024 6 p.m. PDT",1079,1050,629,-450
SCL,"9/16/2024 7 p.m. PDT",1075,1034,644,-431
SCL,"9/16/2024 8 p.m. PDT",1063,1023,623,-440
SCL,"9/16/2024 9 p.m. PDT",1063,1010,693,-370
SCL,"9/16/2024 10 p.m. PDT",998,959,636,-362
SCL,"9/16/2024 11 p.m. PDT",930,891,366,-564
SCL,"9/17/2024 12 a.m. PDT",853,820,222,-631
SCL,"9/17/2024 1 a.m. PDT",807,771,147,-660
SCL,"9/17/2024 2 a.m. PDT",772,741,138,-634
SCL,"9/17/2024 3 a.m. PDT",753,723,139,-614
SCL,"9/17/2024 4 a.m. PDT",747,721,139,-608
SCL,"9/17/2024 5 a.m. PDT",760,741,142,-618
SCL,"9/17/2024 6 a.m. PDT",821,802,154,-667
SCL,"9/17/2024 7 a.m. PDT",924,910,394,-530
SCL,"9/17/2024 8 a.m. PDT",976,988,241,-735
SCL,"9/17/2024 9 a.m. PDT",1048,1010,242,-806
SCL,"9/17/2024 10 a.m. PDT",1061,1019,221,-840
SCL,"9/17/2024 11 a.m. PDT",1041,1022,222,-819
SCL,"9/17/2024 12 p.m. PDT",1068,1025,231,-837
SCL,"9/17/2024 1 p.m. PDT",1060,1028,231,-829
SCL,"9/17/2024 2 p.m. PDT",1060,1029,222,-838
SCL,"9/17/2024 3 p.m. PDT",1050,1020,207,-843
SCL,"9/17/2024 4 p.m. PDT",1038,1017,224,-814
SCL,"9/17/2024 5 p.m. PDT",1051,1028,372,-679
SCL,"9/17/2024 6 p.m. PDT",1056,1038,472,-584
SCL,"9/17/2024 7 p.m. PDT",1057,1032,505,-552
SCL,"9/17/2024 8 p.m. PDT",1070,1042,459,-611
SCL,"9/17/2024 9 p.m. PDT",1058,1027,562,-496
SCL,"9/17/2024 10 p.m. PDT",1007,977,560,-447
SCL,"9/17/2024 11 p.m. PDT",936,906,279,-657
SCL,"9/18/2024 12 a.m. PDT",868,835,205,-663
SCL,"9/18/2024 1 a.m. PDT",813,780,147,-666
SCL,"9/18/2024 2 a.m. PDT",784,743,141,-643
SCL,"9/18/2024 3 a.m. PDT",711,726,147,-564
SCL,"9/18/2024 4 a.m. PDT",704,721,142,-562
SCL,"9/18/2024 5 a.m. PDT",712,738,140,-572
SCL,"9/18/2024 6 a.m. PDT",779,795,145,-634
SCL,"9/18/2024 7 a.m. PDT",879,895,441,-438
SCL,"9/18/2024 8 a.m. PDT",966,972,299,-667
SCL,"9/18/2024 9 a.m. PDT",1008,1000,276,-732
SCL,"9/18/2024 10 a.m. PDT",1025,1011,199,-826
SCL,"9/18/2024 11 a.m. PDT",1022,1018,210,-812
SCL,"9/18/2024 12 p.m. PDT",1024,1021,206,-818
SCL,"9/18/2024 1 p.m. PDT",1026,1025,273,-753
SCL,"9/18/2024 2 p.m. PDT",1021,1030,284,-737
SCL,"9/18/2024 3 p.m. PDT",1014,1029,338,-676
SCL,"9/18/2024 4 p.m. PDT",1018,1037,312,-706
SCL,"9/18/2024 5 p.m. PDT",1026,1053,431,-595
SCL,"9/18/2024 6 p.m. PDT",1032,1055,499,-533
SCL,"9/18/2024 7 p.m. PDT",1027,1042,486,-541
SCL,"9/18/2024 8 p.m. PDT",1017,1041,620,-397
SCL,"9/18/2024 9 p.m. PDT",1002,1023,580,-422
SCL,"9/18/2024 10 p.m. PDT",958,973,369,-589
SCL,"9/18/2024 11 p.m. PDT",888,903,198,-690
SCL,"9/19/2024 12 a.m. PDT",812,833,198,-614
SCL,"9/19/2024 1 a.m. PDT",764,779,204,-560
SCL,"9/19/2024 2 a.m. PDT",725,742,102,-623
SCL,"9/19/2024 3 a.m. PDT",702,723,99,-603
SCL,"9/19/2024 4 a.m. PDT",696,718,98,-598
SCL,"9/19/2024 5 a.m. PDT",712,733,99,-613
SCL,"9/19/2024 6 a.m. PDT",765,791,196,-569
SCL,"9/19/2024 7 a.m. PDT",867,897,463,-404
SCL,"9/19/2024 8 a.m. PDT",953,971,466,-487
SCL,"9/19/2024 9 a.m. PDT",989,995,437,-552
SCL,"9/19/2024 10 a.m. PDT",1013,1009,240,-773
SCL,"9/19/2024 11 a.m. PDT",1000,1017,220,-780
SCL,"9/19/2024 12 p.m. PDT",1001,1021,221,-780
SCL,"9/19/2024 1 p.m. PDT",1027,1023,223,-804
SCL,"9/19/2024 2 p.m. PDT",1016,1025,223,-793
SCL,"9/19/2024 3 p.m. PDT",1007,1017,222,-785
SCL,"9/19/2024 4 p.m. PDT",1019,1024,224,-795
SCL,"9/19/2024 5 p.m. PDT",1028,1035,253,-775
SCL,"9/19/2024 6 p.m. PDT",1037,1050,304,-733
SCL,"9/19/2024 7 p.m. PDT",1015,1033,496,-519
SCL,"9/19/2024 8 p.m. PDT",1017,1037,457,-560
SCL,"9/19/2024 9 p.m. PDT",1001,1020,463,-538
SCL,"9/19/2024 10 p.m. PDT",943,971,401,-542
SCL,"9/19/2024 11 p.m. PDT",881,904,234,-647
SCL,"9/20/2024 12 a.m. PDT",811,836,230,-581
SCL,"9/20/2024 1 a.m. PDT",765,776,138,-627
SCL,"9/20/2024 2 a.m. PDT",723,740,131,-592
SCL,"9/20/2024 3 a.m. PDT",708,721,132,-576
SCL,"9/20/2024 4 a.m. PDT",699,716,130,-569
SCL,"9/20/2024 5 a.m. PDT",715,731,142,-573
SCL,"9/20/2024 6 a.m. PDT",764,790,196,-568
SCL,"9/20/2024 7 a.m. PDT",865,890,459,-406
SCL,"9/20/2024 8 a.m. PDT",954,969,461,-493
SCL,"9/20/2024 9 a.m. PDT",990,997,413,-577
SCL,"9/20/2024 10 a.m. PDT",1007,1006,417,-590
SCL,"9/20/2024 11 a.m. PDT",1014,1009,391,-623
SCL,"9/20/2024 12 p.m. PDT",1014,1010,405,-609
SCL,"9/20/2024 1 p.m. PDT",1007,1009,397,-610
SCL,"9/20/2024 2 p.m. PDT",993,1010,413,-580
SCL,"9/20/2024 3 p.m. PDT",988,1005,406,-582
SCL,"9/20/2024 4 p.m. PDT",986,1006,414,-572
SCL,"9/20/2024 5 p.m. PDT",1004,1018,486,-518
SCL,"9/20/2024 6 p.m. PDT",991,1014,657,-334
SCL,"9/20/2024 7 p.m. PDT",965,997,650,-315
SCL,"9/20/2024 8 p.m. PDT",968,995,651,-317
SCL,"9/20/2024 9 p.m. PDT",952,976,651,-301
SCL,"9/20/2024 10 p.m. PDT",914,933,554,-360
SCL,"9/20/2024 11 p.m. PDT",866,883,213,-653
SCL,"9/21/2024 12 a.m. PDT",810,836,207,-603
SCL,"9/21/2024 1 a.m. PDT",772,783,187,-585
SCL,"9/21/2024 2 a.m. PDT",732,744,109,-623
SCL,"9/21/2024 3 a.m. PDT",712,722,110,-602
SCL,"9/21/2024 4 a.m. PDT",700,712,112,-588
SCL,"9/21/2024 5 a.m. PDT",707,716,114,-593
SCL,"9/21/2024 6 a.m. PDT",728,742,120,-608
SCL,"9/21/2024 7 a.m. PDT",767,789,322,-445
SCL,"9/21/2024 8 a.m. PDT",818,837,325,-493
SCL,"9/21/2024 9 a.m. PDT",874,882,324,-550
SCL,"9/21/2024 10 a.m. PDT",909,912,415,-494
SCL,"9/21/2024 11 a.m. PDT",927,929,416,-511
SCL,"9/21/2024 12 p.m. PDT",926,934,280,-646
SCL,"9/21/2024 1 p.m. PDT",923,928,277,-646
SCL,"9/21/2024 2 p.m. PDT",922,923,278,-644
SCL,"9/21/2024 3 p.m. PDT",912,917,303,-609
SCL,"9/21/2024 4 p.m. PDT",907,920,307,-600
SCL,"9/21/2024 5 p.m. PDT",912,932,457,-455
SCL,"9/21/2024 6 p.m. PDT",932,941,750,-182
SCL,"9/21/2024 7 p.m. PDT",933,948,756,-177
SCL,"9/21/2024 8 p.m. PDT",949,962,755,-194
SCL,"9/21/2024 9 p.m. PDT",934,949,730,-204
SCL,"9/21/2024 10 p.m. PDT",900,916,478,-422
SCL,"9/21/2024 11 p.m. PDT",855,870,103,-752
SCL,"9/22/2024 12 a.m. PDT",808,819,97,-711
SCL,"9/22/2024 1 a.m. PDT",761,778,191,-570
SCL,"9/22/2024 2 a.m. PDT",726,739,114,-612
SCL,"9/22/2024 3 a.m. PDT",704,716,113,-591
SCL,"9/22/2024 4 a.m. PDT",692,705,112,-580
SCL,"9/22/2024 5 a.m. PDT",696,707,113,-583
SCL,"9/22/2024 6 a.m. PDT",710,727,110,-600
SCL,"9/22/2024 7 a.m. PDT",739,770,115,-624
SCL,"9/22/2024 8 a.m. PDT",780,817,288,-492
SCL,"9/22/2024 9 a.m. PDT",848,852,294,-554
SCL,"9/22/2024 10 a.m. PDT",875,891,203,-672
SCL,"9/22/2024 11 a.m. PDT",908,915,203,-705
SCL,"9/22/2024 12 p.m. PDT",919,925,205,-714
SCL,"9/22/2024 1 p.m. PDT",933,926,247,-686
SCL,"9/22/2024 2 p.m. PDT",926,926,247,-679
SCL,"9/22/2024 3 p.m. PDT",931,926,248,-683
SCL,"9/22/2024 4 p.m. PDT",926,929,316,-610
SCL,"9/22/2024 5 p.m. PDT",944,946,351,-593
SCL,"9/22/2024 6 p.m. PDT",968,971,502,-466
SCL,"9/22/2024 7 p.m. PDT",986,989,486,-500
SCL,"9/22/2024 8 p.m. PDT",1006,1005,482,-524
SCL,"9/22/2024 9 p.m. PDT",991,986,486,-505
SCL,"9/22/2024 10 p.m. PDT",937,938,232,-705
SCL,"9/22/2024 11 p.m. PDT",872,877,98,-774
SCL,"9/23/2024 12 a.m. PDT",813,816,100,-713
SCL,"9/23/2024 1 a.m. PDT",758,772,189,-569
SCL,"9/23/2024 2 a.m. PDT",726,741,100,-626
SCL,"9/23/2024 3 a.m. PDT",710,724,98,-612
SCL,"9/23/2024 4 a.m. PDT",708,723,100,-608
SCL,"9/23/2024 5 a.m. PDT",722,742,100,-622
SCL,"9/23/2024 6 a.m. PDT",777,801,103,-674
SCL,"9/23/2024 7 a.m. PDT",882,903,325,-557
SCL,"9/23/2024 8 a.m. PDT",967,982,420,-547
SCL,"9/23/2024 9 a.m. PDT",1004,1010,426,-578
SCL,"9/23/2024 10 a.m. PDT",1028,1022,301,-727
SCL,"9/23/2024 11 a.m. PDT",1043,1028,306,-737
SCL,"9/23/2024 12 p.m. PDT",1056,1033,313,-743
SCL,"9/23/2024 1 p.m. PDT",1061,1039,311,-750
SCL,"9/23/2024 2 p.m. PDT",1058,1043,315,-743
SCL,"9/23/2024 3 p.m. PDT",1054,1042,326,-728
SCL,"9/23/2024 4 p.m. PDT",1060,1050,308,-752
SCL,"9/23/2024 5 p.m. PDT",1089,1065,361,-728
SCL,"9/23/2024 6 p.m. PDT",1099,1088,476,-623
SCL,"9/23/2024 7 p.m. PDT",1085,1072,566,-519
SCL,"9/23/2024 8 p.m. PDT",1078,1069,561,-517
SCL,"9/23/2024 9 p.m. PDT",1043,1044,413,-630
SCL,"9/23/2024 10 p.m. PDT",985,986,394,-591
SCL,"9/23/2024 11 p.m. PDT",905,911,249,-656
SCL,"9/24/2024 12 a.m. PDT",836,842,230,-606
SCL,"9/24/2024 1 a.m. PDT",785,790,132,-653
SCL,"9/24/2024 2 a.m. PDT",745,755,108,-637
SCL,"9/24/2024 3 a.m. PDT",722,733,98,-624
SCL,"9/24/2024 4 a.m. PDT",714,728,97,-617
SCL,"9/24/2024 5 a.m. PDT",724,747,100,-624
SCL,"9/24/2024 6 a.m. PDT",779,805,108,-671
SCL,"9/24/2024 7 a.m. PDT",879,912,426,-453
SCL,"9/24/2024 8 a.m. PDT",964,999,473,-491
SCL,"9/24/2024 9 a.m. PDT",1000,1031,483,-517
SCL,"9/24/2024 10 a.m. PDT",1011,1046,303,-708
SCL,"9/24/2024 11 a.m. PDT",1018,1054,305,-713
SCL,"9/24/2024 12 p.m. PDT",1021,1062,306,-715
SCL,"9/24/2024 1 p.m. PDT",1039,1071,302,-737
SCL,"9/24/2024 2 p.m. PDT",1053,1081,306,-747
SCL,"9/24/2024 3 p.m. PDT",1070,1089,303,-767
SCL,"9/24/2024 4 p.m. PDT",1087,1101,307,-780
SCL,"9/24/2024 5 p.m. PDT",1110,1124,442,-668
SCL,"9/24/2024 6 p.m. PDT",1118,1132,475,-643
SCL,"9/24/2024 7 p.m. PDT",1091,1108,461,-630
SCL,"9/24/2024 8 p.m. PDT",1084,1103,439,-645
SCL,"9/24/2024 9 p.m. PDT",1055,1071,390,-665
SCL,"9/24/2024 10 p.m. PDT",999,1019,346,-653
SCL,"9/24/2024 11 p.m. PDT",924,942,211,-713
SCL,"9/25/2024 12 a.m. PDT",851,869,205,-646
SCL,"9/25/2024 1 a.m. PDT",793,801,215,-578
SCL,"9/25/2024 2 a.m. PDT",751,766,213,-538
SCL,"9/25/2024 3 a.m. PDT",736,744,195,-541
SCL,"9/25/2024 4 a.m. PDT",726,736,199,-527
SCL,"9/25/2024 5 a.m. PDT",738,749,202,-536
SCL,"9/25/2024 6 a.m. PDT",784,804,255,-529
SCL,"9/25/2024 7 a.m. PDT",887,903,433,-454
SCL,"9/25/2024 8 a.m. PDT",956,979,382,-574
SCL,"9/25/2024 9 a.m. PDT",1000,1007,426,-574
SCL,"9/25/2024 10 a.m. PDT",1003,1018,505,-498
SCL,"9/25/2024 11 a.m. PDT",1041,1024,543,-498
SCL,"9/25/2024 12 p.m. PDT",1059,1025,410,-649
SCL,"9/25/2024 1 p.m. PDT",1056,1027,389,-667
SCL,"9/25/2024 2 p.m. PDT",1050,1027,345,-705
SCL,"9/25/2024 3 p.m. PDT",1036,1020,345,-691
SCL,"9/25/2024 4 p.m. PDT",1023,1025,346,-677
SCL,"9/25/2024 5 p.m. PDT",1035,1029,388,-647
SCL,"9/25/2024 6 p.m. PDT",1040,1038,418,-622
SCL,"9/25/2024 7 p.m. PDT",1041,1034,435,-606
SCL,"9/25/2024 8 p.m. PDT",1040,1053,366,-674
SCL,"9/25/2024 9 p.m. PDT",1005,1030,348,-657
SCL,"9/25/2024 10 p.m. PDT",951,979,341,-610
SCL,"9/25/2024 11 p.m. PDT",886,909,214,-672
SCL,"9/26/2024 12 a.m. PDT",810,840,195,-615
SCL,"9/26/2024 1 a.m. PDT",765,774,194,-571
SCL,"9/26/2024 2 a.m. PDT",727,738,200,-527
SCL,"9/26/2024 3 a.m. PDT",707,720,195,-512
SCL,"9/26/2024 4 a.m. PDT",703,716,199,-504
SCL,"9/26/2024 5 a.m. PDT",721,734,196,-525
SCL,"9/26/2024 6 a.m. PDT",777,795,199,-578
SCL,"9/26/2024 7 a.m. PDT",889,904,301,-588
SCL,"9/26/2024 8 a.m. PDT",993,997,300,-693
SCL,"9/26/2024 9 a.m. PDT",1022,1015,552,-470
SCL,"9/26/2024 10 a.m. PDT",1024,1021,423,-601
SCL,"9/26/2024 11 a.m. PDT",1014,1019,413,-601
SCL,"9/26/2024 12 p.m. PDT",1022,1019,99,-923
SCL,"9/26/2024 1 p.m. PDT",1028,1017,103,-925
SCL,"9/26/2024 2 p.m. PDT",1025,1016,104,-921
SCL,"9/26/2024 3 p.m. PDT",1008,1008,360,-648
SCL,"9/26/2024 4 p.m. PDT",991,1015,367,-624
SCL,"9/26/2024 5 p.m. PDT",1004,1031,403,-601
SCL,"9/26/2024 6 p.m. PDT",1016,1044,448,-568
SCL,"9/26/2024 7 p.m. PDT",1012,1036,430,-582
SCL,"9/26/2024 8 p.m. PDT",1025,1046,450,-575
SCL,"9/26/2024 9 p.m. PDT",993,1017,473,-520
SCL,"9/26/2024 10 p.m. PDT",950,965,504,-446
SCL,"9/26/2024 11 p.m. PDT",880,898,427,-453
SCL,"9/27/2024 12 a.m. PDT",813,832,350,-463
SCL,"9/27/2024 1 a.m. PDT",767,773,229,-538
SCL,"9/27/2024 2 a.m. PDT",735,739,197,-538
SCL,"9/27/2024 3 a.m. PDT",719,720,197,-522
SCL,"9/27/2024 4 a.m. PDT",710,715,195,-515
SCL,"9/27/2024 5 a.m. PDT",726,732,202,-524
SCL,"9/27/2024 6 a.m. PDT",776,790,303,-473
SCL,"9/27/2024 7 a.m. PDT",886,889,390,-496
SCL,"9/27/2024 8 a.m. PDT",969,969,484,-485
SCL,"9/27/2024 9 a.m. PDT",1008,1002,455,-553
SCL,"9/27/2024 10 a.m. PDT",1027,1016,459,-568
SCL,"9/27/2024 11 a.m. PDT",1019,1021,597,-422
SCL,"9/27/2024 12 p.m. PDT",1028,1022,594,-434
SCL,"9/27/2024 1 p.m. PDT",1021,1019,550,-471
SCL,"9/27/2024 2 p.m. PDT",1022,1021,553,-469
SCL,"9/27/2024 3 p.m. PDT",1008,1016,557,-451
SCL,"9/27/2024 4 p.m. PDT",1020,1019,577,-443
SCL,"9/27/2024 5 p.m. PDT",1033,1026,591,-442
SCL,"9/27/2024 6 p.m. PDT",1042,1029,633,-409
SCL,"9/27/2024 7 p.m. PDT",1020,1010,591,-429
SCL,"9/27/2024 8 p.m. PDT",1020,1012,492,-528
SCL,"9/27/2024 9 p.m. PDT",999,984,491,-508
SCL,"9/27/2024 10 p.m. PDT",953,939,490,-463
SCL,"9/27/2024 11 p.m. PDT",899,889,528,-371
SCL,"9/28/2024 12 a.m. PDT",861,842,440,-421
SCL,"9/28/2024 1 a.m. PDT",811,783,288,-523
SCL,"9/28/2024 2 a.m. PDT",773,750,267,-506
SCL,"9/28/2024 3 a.m. PDT",752,729,271,-481
SCL,"9/28/2024 4 a.m. PDT",729,719,257,-472
SCL,"9/28/2024 5 a.m. PDT",718,724,268,-450
SCL,"9/28/2024 6 a.m. PDT",741,750,291,-450
SCL,"9/28/2024 7 a.m. PDT",796,795,410,-386
SCL,"9/28/2024 8 a.m. PDT",859,852,451,-408
SCL,"9/28/2024 9 a.m. PDT",928,902,476,-452
SCL,"9/28/2024 10 a.m. PDT",953,933,244,-709
SCL,"9/28/2024 11 a.m. PDT",967,948,375,-592
SCL,"9/28/2024 12 p.m. PDT",978,950,373,-605
SCL,"9/28/2024 1 p.m. PDT",972,942,379,-593
SCL,"9/28/2024 2 p.m. PDT",965,933,377,-588
SCL,"9/28/2024 3 p.m. PDT",965,925,480,-485
SCL,"9/28/2024 4 p.m. PDT",963,923,551,-412
SCL,"9/28/2024 5 p.m. PDT",965,932,637,-328
SCL,"9/28/2024 6 p.m. PDT",985,946,668,-317
SCL,"9/28/2024 7 p.m. PDT",994,960,660,-334
SCL,"9/28/2024 8 p.m. PDT",1003,982,628,-375
SCL,"9/28/2024 9 p.m. PDT",981,963,613,-368
SCL,"9/28/2024 10 p.m. PDT",948,926,403,-545
SCL,"9/28/2024 11 p.m. PDT",904,886,381,-523
SCL,"9/29/2024 12 a.m. PDT",859,839,224,-635
SCL,"9/29/2024 1 a.m. PDT",812,784,332,-480
SCL,"9/29/2024 2 a.m. PDT",782,754,348,-434
SCL,"9/29/2024 3 a.m. PDT",760,733,315,-445
SCL,"9/29/2024 4 a.m. PDT",750,725,305,-445
SCL,"9/29/2024 5 a.m. PDT",752,731,306,-446
SCL,"9/29/2024 6 a.m. PDT",764,757,326,-438
SCL,"9/29/2024 7 a.m. PDT",798,803,391,-407
SCL,"9/29/2024 8 a.m. PDT",852,857,417,-435
SCL,"9/29/2024 9 a.m. PDT",902,899,461,-441
SCL,"9/29/2024 10 a.m. PDT",943,931,374,-569
SCL,"9/29/2024 11 a.m. PDT",953,948,377,-576
SCL,"9/29/2024 12 p.m. PDT",962,950,365,-597
SCL,"9/29/2024 1 p.m. PDT",962,942,379,-583
SCL,"9/29/2024 2 p.m. PDT",964,938,369,-595
SCL,"9/29/2024 3 p.m. PDT",967,933,366,-601
SCL,"9/29/2024 4 p.m. PDT",971,932,394,-577
SCL,"9/29/2024 5 p.m. PDT",977,946,475,-502
SCL,"9/29/2024 6 p.m. PDT",1004,975,837,-167
SCL,"9/29/2024 7 p.m. PDT",1032,998,830,-202
SCL,"9/29/2024 8 p.m. PDT",1054,1018,851,-203
SCL,"9/29/2024 9 p.m. PDT",1018,998,629,-389
SCL,"9/29/2024 10 p.m. PDT",973,965,564,-409
SCL,"9/29/2024 11 p.m. PDT",919,902,527,-392
SCL,"9/30/2024 12 a.m. PDT",859,843,438,-421
SCL,"9/30/2024 1 a.m. PDT",809,768,441,-368
SCL,"9/30/2024 2 a.m. PDT",773,742,429,-344
SCL,"9/30/2024 3 a.m. PDT",754,729,434,-320
SCL,"9/30/2024 4 a.m. PDT",764,732,428,-336
SCL,"9/30/2024 5 a.m. PDT",788,759,450,-338
SCL,"9/30/2024 6 a.m. PDT",862,835,486,-376
SCL,"9/30/2024 7 a.m. PDT",986,957,433,-553
SCL,"9/30/2024 8 a.m. PDT",1087,1059,465,-622
SCL,"9/30/2024 9 a.m. PDT",1118,1078,153,-965
SCL,"9/30/2024 10 a.m. PDT",1120,1073,151,-969
SCL,"9/30/2024 11 a.m. PDT",1066,1059,114,-952
SCL,"9/30/2024 12 p.m. PDT",1058,1047,131,-927
SCL,"9/30/2024 1 p.m. PDT",1090,1044,112,-978
SCL,"9/30/2024 2 p.m. PDT",1076,1037,160,-916
SCL,"9/30/2024 3 p.m. PDT",1045,1026,157,-888
SCL,"9/30/2024 4 p.m. PDT",1036,1026,175,-861
SCL,"9/30/2024 5 p.m. PDT",1045,1039,182,-863
SCL,"9/30/2024 6 p.m. PDT",1072,1058,305,-767
SCL,"9/30/2024 7 p.m. PDT",1079,1060,838,-241
SCL,"9/30/2024 8 p.m. PDT",1088,1063,910,-178
SCL,"9/30/2024 9 p.m. PDT",1058,1036,903,-155
SCL,"9/30/2024 10 p.m. PDT",1011,987,783,-228
SCL,"9/30/2024 11 p.m. PDT",890,916,797,-93