"BA Code","Timestamp (Hour Ending)","Demand (MWh)","Demand Forecast (MWh)","Net Generation (MWh)","Total Interchange (MWh)"
SCL,"1/1/2024 7 a.m. PST",1144,1136,346,-798
SCL,"1/1/2024 8 a.m. PST",1188,1190,374,-814
SCL,"1/1/2024 9 a.m. PST",1212,1226,404,-808
SCL,"1/1/2024 10 a.m. PST",1207,1243,420,-787
SCL,"1/1/2024 11 a.m. PST",1221,1253,479,-742
SCL,"1/1/2024 12 p.m. PST",1262,1258,464,-798
SCL,"1/1/2024 1 p.m. PST",1279,1243,462,-817
SCL,"1/1/2024 2 p.m. PST",1263,1227,398,-865
SCL,"1/1/2024 3 p.m. PST",1252,1212,401,-851
SCL,"1/1/2024 4 p.m. PST",1270,1226,437,-833
SCL,"1/1/2024 5 p.m. PST",1350,1287,577,-773
SCL,"1/1/2024 6 p.m. PST",1397,1359,681,-716
SCL,"1/1/2024 7 p.m. PST",1372,1346,625,-747
SCL,"1/1/2024 8 p.m. PST",1338,1310,585,-753
SCL,"1/1/2024 9 p.m. PST",1298,1268,574,-724
SCL,"1/1/2024 10 p.m. PST",1243,1208,476,-767
SCL,"1/1/2024 11 p.m. PST",1181,1128,390,-791
SCL,"1/2/2024 12 a.m. PST",1092,1058,271,-821
SCL,"1/2/2024 1 a.m. PST",1044,1028,296,-748
SCL,"1/2/2024 2 a.m. PST",1012,982,254,-758
SCL,"1/2/2024 3 a.m. PST",1002,970,247,-755
SCL,"1/2/2024 4 a.m. PST",1017,984,239,-778
SCL,"1/2/2024 5 a.m. PST",1057,1039,256,-801
SCL,"1/2/2024 6 a.m. PST",1161,1147,306,-855
SCL,"1/2/2024 7 a.m. PST",1289,1290,339,-950
SCL,"1/2/2024 8 a.m. PST",1396,1412,400,-996
SCL,"1/2/2024 9 a.m. PST",1428,1440,440,-988
SCL,"1/2/2024 10 a.m. PST",1412,1434,464,-948
SCL,"1/2/2024 11 a.m. PST",1440,1408,535,-905
SCL,"1/2/2024 12 p.m. PST",1451,1388,499,-952
SCL,"1/2/2024 1 p.m. PST",1461,1383,534,-927
SCL,"1/2/2024 2 p.m. PST",1437,1362,491,-946
SCL,"1/2/2024 3 p.m. PST",1428,1339,481,-947
SCL,"1/2/2024 4 p.m. PST",1438,1351,410,-1028
SCL,"1/2/2024 5 p.m. PST",1467,1398,500,-967
SCL,"1/2/2024 6 p.m. PST",1487,1463,706,-781
SCL,"1/2/2024 7 p.m. PST",1448,1445,607,-841
SCL,"1/2/2024 8 p.m. PST",1412,1396,592,-820
SCL,"1/2/2024 9 p.m. PST",1355,1346,592,-763
SCL,"1/2/2024 10 p.m. PST",1280,1275,426,-854
SCL,"1/2/2024 11 p.m. PST",1172,1180,380,-792
SCL,"1/3/2024 12 a.m. PST",1105,1089,339,-766
SCL,"1/3/2024 1 a.m. PST",1042,1013,255,-787
SCL,"1/3/2024 2 a.m. PST",997,973,235,-762
SCL,"1/3/2024 3 a.m. PST",973,958,238,-735
SCL,"1/3/2024 4 a.m. PST",993,965,232,-761
SCL,"1/3/2024 5 a.m. PST",1022,1009,229,-793
SCL,"1/3/2024 6 a.m. PST",1123,1110,273,-850
SCL,"1/3/2024 7 a.m. PST",1234,1244,337,-897
SCL,"1/3/2024 8 a.m. PST",1334,1364,453,-881
SCL,"1/3/2024 9 a.m. PST",1354,1389,523,-831
SCL,"1/3/2024 10 a.m. PST",1366,1380,541,-825
SCL,"1/3/2024 11 a.m. PST",1317,1359,468,-849
SCL,"1/3/2024 12 p.m. PST",1307,1341,512,-795
SCL,"1/3/2024 1 p.m. PST",1299,1332,557,-742
SCL,"1/3/2024 2 p.m. PST",1297,1320,482,-815
SCL,"1/3/2024 3 p.m. PST",1305,1293,507,-798
SCL,"1/3/2024 4 p.m. PST",1332,1313,441,-891
SCL,"1/3/2024 5 p.m. PST",1371,1353,466,-905
SCL,"1/3/2024 6 p.m. PST",1410,1415,588,-822
SCL,"1/3/2024 7 p.m. PST",1378,1396,598,-780
SCL,"1/3/2024 8 p.m. PST",1339,1353,609,-730
SCL,"1/3/2024 9 p.m. PST",1287,1305,625,-662
SCL,"1/3/2024 10 p.m. PST",1226,1229,648,-578
SCL,"1/3/2024 11 p.m. PST",1137,1138,520,-617
SCL,"1/4/2024 12 a.m. PST",1053,1056,287,-766
SCL,"1/4/2024 1 a.m. PST",992,1002,376,-616
SCL,"1/4/2024 2 a.m. PST",954,965,299,-655
SCL,"1/4/2024 3 a.m. PST",937,948,273,-664
SCL,"1/4/2024 4 a.m. PST",944,952,265,-679
SCL,"1/4/2024 5 a.m. PST",976,990,269,-707
SCL,"1/4/2024 6 a.m. PST",1078,1087,314,-764
SCL,"1/4/2024 7 a.m. PST",1224,1219,339,-885
SCL,"1/4/2024 8 a.m. PST",1333,1340,458,-875
SCL,"1/4/2024 9 a.m. PST",1346,1361,430,-916
SCL,"1/4/2024 10 a.m. PST",1353,1360,423,-930
SCL,"1/4/2024 11 a.m. PST",1358,1351,507,-851
SCL,"1/4/2024 12 p.m. PST",1358,1338,471,-887
SCL,"1/4/2024 1 p.m. PST",1351,1335,451,-900
SCL,"1/4/2024 2 p.m. PST",1329,1324,467,-862
SCL,"1/4/2024 3 p.m. PST",1316,1302,487,-829
SCL,"1/4/2024 4 p.m. PST",1318,1299,415,-903
SCL,"1/4/2024 5 p.m. PST",1349,1346,615,-734
SCL,"1/4/2024 6 p.m. PST",1396,1406,636,-760
SCL,"1/4/2024 7 p.m. PST",1371,1392,566,-805
SCL,"1/4/2024 8 p.m. PST",1343,1344,639,-704
SCL,"1/4/2024 9 p.m. PST",1297,1301,627,-670
SCL,"1/4/2024 10 p.m. PST",1238,1234,557,-681
SCL,"1/4/2024 11 p.m. PST",1152,1145,403,-749
SCL,"1/5/2024 12 a.m. PST",1068,1073,314,-754
SCL,"1/5/2024 1 a.m. PST",1014,1020,329,-685
SCL,"1/5/2024 2 a.m. PST",982,987,300,-682
SCL,"1/5/2024 3 a.m. PST",966,972,282,-684
SCL,"1/5/2024 4 a.m. PST",964,978,336,-628
SCL,"1/5/2024 5 a.m. PST",1023,1021,382,-641
SCL,"1/5/2024 6 a.m. PST",1139,1116,483,-656
SCL,"1/5/2024 7 a.m. PST",1281,1245,596,-685
SCL,"1/5/2024 8 a.m. PST",1383,1361,628,-755
SCL,"1/5/2024 9 a.m. PST",1424,1396,555,-869
SCL,"1/5/2024 10 a.m. PST",1434,1396,514,-920
SCL,"1/5/2024 11 a.m. PST",1435,1378,505,-930
SCL,"1/5/2024 12 p.m. PST",1428,1369,537,-891
SCL,"1/5/2024 1 p.m. PST",1426,1359,558,-868
SCL,"1/5/2024 2 p.m. PST",1421,1340,519,-902
SCL,"1/5/2024 3 p.m. PST",1426,1311,516,-910
SCL,"1/5/2024 4 p.m. PST",1428,1335,491,-937
SCL,"1/5/2024 5 p.m. PST",1474,1370,568,-906
SCL,"1/5/2024 6 p.m. PST",1484,1419,657,-827
SCL,"1/5/2024 7 p.m. PST",1437,1388,610,-827
SCL,"1/5/2024 8 p.m. PST",1386,1328,592,-794
SCL,"1/5/2024 9 p.m. PST",1341,1280,516,-825
SCL,"1/5/2024 10 p.m. PST",1280,1217,475,-805
SCL,"1/5/2024 11 p.m. PST",1210,1152,482,-728
SCL,"1/6/2024 12 a.m. PST",1137,1087,512,-625
SCL,"1/6/2024 1 a.m. PST",1077,1043,396,-681
SCL,"1/6/2024 2 a.m. PST",1043,1002,329,-714
SCL,"1/6/2024 3 a.m. PST",1030,981,296,-734
SCL,"1/6/2024 4 a.m. PST",1019,974,297,-722
SCL,"1/6/2024 5 a.m. PST",1037,983,333,-704
SCL,"1/6/2024 6 a.m. PST",1065,1016,381,-684
SCL,"1/6/2024 7 a.m. PST",1130,1059,387,-743
SCL,"1/6/2024 8 a.m. PST",1190,1130,469,-721
SCL,"1/6/2024 9 a.m. PST",1252,1208,493,-759
SCL,"1/6/2024 10 a.m. PST",1291,1265,502,-789
SCL,"1/6/2024 11 a.m. PST",1319,1292,507,-812
SCL,"1/6/2024 12 p.m. PST",1344,1301,494,-850
SCL,"1/6/2024 1 p.m. PST",1316,1296,499,-817
SCL,"1/6/2024 2 p.m. PST",1299,1274,546,-753
SCL,"1/6/2024 3 p.m. PST",1291,1264,577,-714
SCL,"1/6/2024 4 p.m. PST",1284,1263,599,-685
SCL,"1/6/2024 5 p.m. PST",1350,1303,639,-711
SCL,"1/6/2024 6 p.m. PST",1413,1359,780,-633
SCL,"1/6/2024 7 p.m. PST",1409,1347,780,-629
SCL,"1/6/2024 8 p.m. PST",1393,1314,763,-630
SCL,"1/6/2024 9 p.m. PST",1352,1272,605,-747
SCL,"1/6/2024 10 p.m. PST",1296,1226,563,-733
SCL,"1/6/2024 11 p.m. PST",1226,1166,579,-647
SCL,"1/7/2024 12 a.m. PST",1163,1107,459,-704
SCL,"1/7/2024 1 a.m. PST",1111,1087,428,-683
SCL,"1/7/2024 2 a.m. PST",1080,1043,283,-797
SCL,"1/7/2024 3 a.m. PST",1044,1025,269,-775
SCL,"1/7/2024 4 a.m. PST",1043,1021,272,-771
SCL,"1/7/2024 5 a.m. PST",1058,1028,303,-755
SCL,"1/7/2024 6 a.m. PST",1086,1055,350,-736
SCL,"1/7/2024 7 a.m. PST",1130,1092,427,-703
SCL,"1/7/2024 8 a.m. PST",1199,1151,445,-754
SCL,"1/7/2024 9 a.m. PST",1252,1215,464,-788
SCL,"1/7/2024 10 a.m. PST",1309,1275,506,-803
SCL,"1/7/2024 11 a.m. PST",1343,1302,487,-856
SCL,"1/7/2024 12 p.m. PST",1357,1309,490,-867
SCL,"1/7/2024 1 p.m. PST",1356,1307,469,-887
SCL,"1/7/2024 2 p.m. PST",1349,1296,499,-850
SCL,"1/7/2024 3 p.m. PST",1357,1276,493,-864
SCL,"1/7/2024 4 p.m. PST",1370,1291,474,-896
SCL,"1/7/2024 5 p.m. PST",1414,1340,580,-834
SCL,"1/7/2024 6 p.m. PST",1482,1413,744,-738
SCL,"1/7/2024 7 p.m. PST",1480,1419,754,-726
SCL,"1/7/2024 8 p.m. PST",1463,1403,747,-716
SCL,"1/7/2024 9 p.m. PST",1409,1360,684,-725
SCL,"1/7/2024 10 p.m. PST",1341,1290,626,-715
SCL,"1/7/2024 11 p.m. PST",1240,1209,534,-706
SCL,"1/8/2024 12 a.m. PST",1178,1126,409,-769
SCL,"1/8/2024 1 a.m. PST",1120,1087,399,-721
SCL,"1/8/2024 2 a.m. PST",1068,1054,364,-704
SCL,"1/8/2024 3 a.m. PST",1078,1045,357,-721
SCL,"1/8/2024 4 a.m. PST",1107,1062,368,-739
SCL,"1/8/2024 5 a.m. PST",1146,1113,391,-755
SCL,"1/8/2024 6 a.m. PST",1249,1217,510,-739
SCL,"1/8/2024 7 a.m. PST",1404,1352,505,-899
SCL,"1/8/2024 8 a.m. PST",1529,1470,551,-978
SCL,"1/8/2024 9 a.m. PST",1569,1507,568,-1001
SCL,"1/8/2024 10 a.m. PST",1586,1499,567,-1019
SCL,"1/8/2024 11 a.m. PST",1578,1476,652,-926
SCL,"1/8/2024 12 p.m. PST",1574,1461,767,-807
SCL,"1/8/2024 1 p.m. PST",1568,1449,783,-785
SCL,"1/8/2024 2 p.m. PST",1549,1431,755,-794
SCL,"1/8/2024 3 p.m. PST",1551,1410,746,-805
SCL,"1/8/2024 4 p.m. PST",1553,1411,601,-952
SCL,"1/8/2024 5 p.m. PST",1573,1445,677,-896
SCL,"1/8/2024 6 p.m. PST",1585,1500,675,-910
SCL,"1/8/2024 7 p.m. PST",1530,1476,647,-883
SCL,"1/8/2024 8 p.m. PST",1465,1417,551,-914
SCL,"1/8/2024 9 p.m. PST",1413,1358,415,-998
SCL,"1/8/2024 10 p.m. PST",1349,1273,350,-999
SCL,"1/8/2024 11 p.m. PST",1248,1167,413,-835
SCL,"1/9/2024 12 a.m. PST",1159,1080,363,-796
SCL,"1/9/2024 1 a.m. PST",1087,1037,271,-816
SCL,"1/9/2024 2 a.m. PST",1056,1004,245,-811
SCL,"1/9/2024 3 a.m. PST",1045,985,251,-794
SCL,"1/9/2024 4 a.m. PST",1057,991,247,-810
SCL,"1/9/2024 5 a.m. PST",1113,1037,199,-914
SCL,"1/9/2024 6 a.m. PST",1215,1138,266,-949
SCL,"1/9/2024 7 a.m. PST",1343,1281,316,-1027
SCL,"1/9/2024 8 a.m. PST",1439,1409,422,-1017
SCL,"1/9/2024 9 a.m. PST",1491,1447,512,-979
SCL,"1/9/2024 10 a.m. PST",1511,1450,471,-1040
SCL,"1/9/2024 11 a.m. PST",1480,1442,405,-1075
SCL,"1/9/2024 12 p.m. PST",1490,1440,449,-1041
SCL,"1/9/2024 1 p.m. PST",1484,1445,440,-1044
SCL,"1/9/2024 2 p.m. PST",1480,1440,449,-1031
SCL,"1/9/2024 3 p.m. PST",1461,1422,432,-1029
SCL,"1/9/2024 4 p.m. PST",1456,1438,423,-1033
SCL,"1/9/2024 5 p.m. PST",1495,1484,483,-1012
SCL,"1/9/2024 6 p.m. PST",1564,1538,503,-1061
SCL,"1/9/2024 7 p.m. PST",1543,1522,486,-1057
SCL,"1/9/2024 8 p.m. PST",1502,1473,458,-1044
SCL,"1/9/2024 9 p.m. PST",1465,1416,410,-1055
SCL,"1/9/2024 10 p.m. PST",1386,1340,385,-1001
SCL,"1/9/2024 11 p.m. PST",1290,1239,473,-817
SCL,"1/10/2024 12 a.m. PST",1193,1147,492,-701
SCL,"1/10/2024 1 a.m. PST",1137,1093,413,-724
SCL,"1/10/2024 2 a.m. PST",1100,1056,363,-737
SCL,"1/10/2024 3 a.m. PST",1091,1040,359,-732
SCL,"1/10/2024 4 a.m. PST",1099,1046,347,-752
SCL,"1/10/2024 5 a.m. PST",1153,1086,351,-802
SCL,"1/10/2024 6 a.m. PST",1251,1186,456,-795
SCL,"1/10/2024 7 a.m. PST",1411,1323,438,-973
SCL,"1/10/2024 8 a.m. PST",1527,1439,495,-1032
SCL,"1/10/2024 9 a.m. PST",1556,1469,513,-1043
SCL,"1/10/2024 10 a.m. PST",1561,1462,500,-1061
SCL,"1/10/2024 11 a.m. PST",1535,1446,476,-1059
SCL,"1/10/2024 12 p.m. PST",1515,1435,585,-930
SCL,"1/10/2024 1 p.m. PST",1490,1426,578,-912
SCL,"1/10/2024 2 p.m. PST",1447,1415,496,-951
SCL,"1/10/2024 3 p.m. PST",1389,1401,488,-901
SCL,"1/10/2024 4 p.m. PST",1443,1407,494,-949
SCL,"1/10/2024 5 p.m. PST",1505,1445,492,-1013
SCL,"1/10/2024 6 p.m. PST",1564,1512,535,-1029
SCL,"1/10/2024 7 p.m. PST",1548,1497,505,-1043
SCL,"1/10/2024 8 p.m. PST",1517,1458,498,-1019
SCL,"1/10/2024 9 p.m. PST",1479,1402,429,-1050
SCL,"1/10/2024 10 p.m. PST",1406,1330,396,-1010
SCL,"1/10/2024 11 p.m. PST",1303,1228,434,-869
SCL,"1/11/2024 12 a.m. PST",1212,1149,383,-829
SCL,"1/11/2024 1 a.m. PST",1112,1114,254,-858
SCL,"1/11/2024 2 a.m. PST",1080,1090,218,-862
SCL,"1/11/2024 3 a.m. PST",1066,1077,214,-852
SCL,"1/11/2024 4 a.m. PST",1079,1086,217,-862
SCL,"1/11/2024 5 a.m. PST",1117,1130,218,-899
SCL,"1/11/2024 6 a.m. PST",1231,1236,292,-939
SCL,"1/11/2024 7 a.m. PST",1383,1383,401,-982
SCL,"1/11/2024 8 a.m. PST",1503,1509,501,-1002
SCL,"1/11/2024 9 a.m. PST",1527,1545,502,-1025
SCL,"1/11/2024 10 a.m. PST",1525,1539,490,-1035
SCL,"1/11/2024 11 a.m. PST",1507,1522,484,-1023
SCL,"1/11/2024 12 p.m. PST",1454,1506,495,-959
SCL,"1/11/2024 1 p.m. PST",1409,1494,490,-919
SCL,"1/11/2024 2 p.m. PST",1379,1476,425,-954
SCL,"1/11/2024 3 p.m. PST",1371,1477,445,-926
SCL,"1/11/2024 4 p.m. PST",1421,1493,515,-906
SCL,"1/11/2024 5 p.m. PST",1530,1548,573,-957
SCL,"1/11/2024 6 p.m. PST",1621,1612,624,-997
SCL,"1/11/2024 7 p.m. PST",1622,1592,659,-963
SCL,"1/11/2024 8 p.m. PST",1609,1550,621,-988
SCL,"1/11/2024 9 p.m. PST",1586,1497,518,-1068
SCL,"1/11/2024 10 p.m. PST",1521,1422,477,-1044
SCL,"1/11/2024 11 p.m. PST",1449,1329,477,-972
SCL,"1/12/2024 12 a.m. PST",1367,1244,445,-922
SCL,"1/12/2024 1 a.m. PST",1310,1315,393,-917
SCL,"1/12/2024 2 a.m. PST",1294,1290,446,-848
SCL,"1/12/2024 3 a.m. PST",1289,1283,417,-872
SCL,"1/12/2024 4 a.m. PST",1320,1293,406,-914
SCL,"1/12/2024 5 a.m. PST",1391,1333,535,-856
SCL,"1/12/2024 6 a.m. PST",1489,1423,510,-979
SCL,"1/12/2024 7 a.m. PST",1619,1555,664,-955
SCL,"1/12/2024 8 a.m. PST",1778,1679,644,-1134
SCL,"1/12/2024 9 a.m. PST",1857,1724,574,-1283
SCL,"1/12/2024 10 a.m. PST",1892,1739,516,-1376
SCL,"1/12/2024 11 a.m. PST",1914,1747,672,-1242
SCL,"1/12/2024 12 p.m. PST",1913,1768,541,-1372
SCL,"1/12/2024 1 p.m. PST",1924,1790,506,-1418
SCL,"1/12/2024 2 p.m. PST",1918,1768,559,-1359
SCL,"1/12/2024 3 p.m. PST",1899,1757,640,-1259
SCL,"1/12/2024 4 p.m. PST",1881,1762,779,-1102
SCL,"1/12/2024 5 p.m. PST",1964,1796,981,-983
SCL,"1/12/2024 6 p.m. PST",2027,1829,1195,-832
SCL,"1/12/2024 7 p.m. PST",1996,1790,1157,-839
SCL,"1/12/2024 8 p.m. PST",1956,1719,1020,-936
SCL,"1/12/2024 9 p.m. PST",1914,1657,995,-919
SCL,"1/12/2024 10 p.m. PST",1840,1607,895,-945
SCL,"1/12/2024 11 p.m. PST",1773,1546,858,-915
SCL,"1/13/2024 12 a.m. PST",1693,1371,699,-994
SCL,"1/13/2024 1 a.m. PST",1630,1539,508,-1122
SCL,"1/13/2024 2 a.m. PST",1598,1478,376,-1222
SCL,"1/13/2024 3 a.m. PST",1592,1443,373,-1219
SCL,"1/13/2024 4 a.m. PST",1577,1433,400,-1177
SCL,"1/13/2024 5 a.m. PST",1609,1449,424,-1185
SCL,"1/13/2024 6 a.m. PST",1632,1484,573,-1059
SCL,"1/13/2024 7 a.m. PST",1676,1556,579,-1097
SCL,"1/13/2024 8 a.m. PST",1777,1642,693,-1084
SCL,"1/13/2024 9 a.m. PST",1846,1707,848,-998
SCL,"1/13/2024 10 a.m. PST",1896,1757,934,-962
SCL,"1/13/2024 11 a.m. PST",1918,1775,1029,-889
SCL,"1/13/2024 12 p.m. PST",1929,1773,1015,-914
SCL,"1/13/2024 1 p.m. PST",1901,1760,854,-1047
SCL,"1/13/2024 2 p.m. PST",1890,1716,832,-1058
SCL,"1/13/2024 3 p.m. PST",1879,1717,763,-1116
SCL,"1/13/2024 4 p.m. PST",1890,1665,789,-1101
SCL,"1/13/2024 5 p.m. PST",1913,1712,966,-947
SCL,"1/13/2024 6 p.m. PST",1959,1781,1044,-915
SCL,"1/13/2024 7 p.m. PST",1915,1842,1039,-876
SCL,"1/13/2024 8 p.m. PST",1911,1742,945,-966
SCL,"1/13/2024 9 p.m. PST",1873,1651,744,-1129
SCL,"1/13/2024 10 p.m. PST",1831,1582,629,-1202
SCL,"1/13/2024 11 p.m. PST",1757,1478,660,-1097
SCL,"1/14/2024 12 a.m. PST",1673,1402,522,-1151
SCL,"1/14/2024 1 a.m. PST",1611,1537,664,-947
SCL,"1/14/2024 2 a.m. PST",1578,1480,585,-993
SCL,"1/14/2024 3 a.m. PST",1552,1447,592,-960
SCL,"1/14/2024 4 a.m. PST",1571,1433,647,-924
SCL,"1/14/2024 5 a.m. PST",1576,1427,658,-918
SCL,"1/14/2024 6 a.m. PST",1601,1452,616,-985
SCL,"1/14/2024 7 a.m. PST",1650,1497,706,-944
SCL,"1/14/2024 8 a.m. PST",1718,1529,900,-818
SCL,"1/14/2024 9 a.m. PST",1769,1569,788,-981
SCL,"1/14/2024 10 a.m. PST",1792,1584,804,-988
SCL,"1/14/2024 11 a.m. PST",1782,1596,823,-959
SCL,"1/14/2024 12 p.m. PST",1759,1600,642,-1117
SCL,"1/14/2024 1 p.m. PST",1732,1564,554,-1178
SCL,"1/14/2024 2 p.m. PST",1713,1533,487,-1226
SCL,"1/14/2024 3 p.m. PST",1684,1502,498,-1186
SCL,"1/14/2024 4 p.m. PST",1650,1513,494,-1156
SCL,"1/14/2024 5 p.m. PST",1725,1561,860,-865
SCL,"1/14/2024 6 p.m. PST",1829,1658,1071,-758
SCL,"1/14/2024 7 p.m. PST",1793,1678,1078,-715
SCL,"1/14/2024 8 p.m. PST",1812,1674,814,-998
SCL,"1/14/2024 9 p.m. PST",1780,1644,771,-1009
SCL,"1/14/2024 10 p.m. PST",1717,1571,734,-983
SCL,"1/14/2024 11 p.m. PST",1654,1492,654,-1000
SCL,"1/15/2024 12 a.m. PST",1543,1412,619,-924
SCL,"1/15/2024 1 a.m. PST",1505,1471,556,-949
SCL,"1/15/2024 2 a.m. PST",1456,1435,485,-971
SCL,"1/15/2024 3 a.m. PST",1481,1417,475,-1006
SCL,"1/15/2024 4 a.m. PST",1495,1415,488,-1007
SCL,"1/15/2024 5 a.m. PST",1519,1433,532,-987
SCL,"1/15/2024 6 a.m. PST",1605,1503,601,-1004
SCL,"1/15/2024 7 a.m. PST",1688,1591,669,-1019
SCL,"1/15/2024 8 a.m. PST",1776,1654,876,-900
SCL,"1/15/2024 9 a.m. PST",1825,1709,843,-982
SCL,"1/15/2024 10 a.m. PST",1833,1714,897,-936
SCL,"1/15/2024 11 a.m. PST",1813,1697,889,-924
SCL,"1/15/2024 12 p.m. PST",1767,1675,896,-871
SCL,"1/15/2024 1 p.m. PST",1721,1625,799,-922
SCL,"1/15/2024 2 p.m. PST",1687,1589,882,-805
SCL,"1/15/2024 3 p.m. PST",1700,1561,904,-796
SCL,"1/15/2024 4 p.m. PST",1713,1572,910,-803
SCL,"1/15/2024 5 p.m. PST",1747,1634,896,-851
SCL,"1/15/2024 6 p.m. PST",1843,1728,1049,-794
SCL,"1/15/2024 7 p.m. PST",1826,1724,1062,-764
SCL,"1/15/2024 8 p.m. PST",1793,1696,920,-873
SCL,"1/15/2024 9 p.m. PST",1752,1646,777,-975
SCL,"1/15/2024 10 p.m. PST",1683,1551,697,-986
SCL,"1/15/2024 11 p.m. PST",1580,1449,588,-992
SCL,"1/16/2024 12 a.m. PST",1484,1369,547,-937
SCL,"1/16/2024 1 a.m. PST",1431,1374,593,-838
SCL,"1/16/2024 2 a.m. PST",1406,1346,560,-846
SCL,"1/16/2024 3 a.m. PST",1402,1338,546,-856
SCL,"1/16/2024 4 a.m. PST",1418,1343,464,-954
SCL,"1/16/2024 5 a.m. PST",1458,1375,599,-859
SCL,"1/16/2024 6 a.m. PST",1568,1457,630,-938
SCL,"1/16/2024 7 a.m. PST",1700,1572,758,-942
SCL,"1/16/2024 8 a.m. PST",1812,1679,892,-920
SCL,"1/16/2024 9 a.m. PST",1848,1699,1001,-847
SCL,"1/16/2024 10 a.m. PST",1844,1685,949,-895
SCL,"1/16/2024 11 a.m. PST",1820,1656,932,-888
SCL,"1/16/2024 12 p.m. PST",1742,1628,859,-883
SCL,"1/16/2024 1 p.m. PST",1684,1603,843,-841
SCL,"1/16/2024 2 p.m. PST",1680,1567,749,-931
SCL,"1/16/2024 3 p.m. PST",1658,1535,839,-819
SCL,"1/16/2024 4 p.m. PST",1691,1546,875,-816
SCL,"1/16/2024 5 p.m. PST",1738,1598,909,-829
SCL,"1/16/2024 6 p.m. PST",1795,1670,998,-797
SCL,"1/16/2024 7 p.m. PST",1770,1659,804,-966
SCL,"1/16/2024 8 p.m. PST",1725,1627,770,-955
SCL,"1/16/2024 9 p.m. PST",1667,1575,569,-1098
SCL,"1/16/2024 10 p.m. PST",1603,1483,627,-976
SCL,"1/16/2024 11 p.m. PST",1504,1371,659,-845
SCL,"1/17/2024 12 a.m. PST",1409,1276,541,-868
SCL,"1/17/2024 1 a.m. PST",1344,1316,525,-819
SCL,"1/17/2024 2 a.m. PST",1308,1281,521,-787
SCL,"1/17/2024 3 a.m. PST",1298,1273,382,-916
SCL,"1/17/2024 4 a.m. PST",1304,1275,382,-922
SCL,"1/17/2024 5 a.m. PST",1340,1296,581,-759
SCL,"1/17/2024 6 a.m. PST",1434,1377,659,-775
SCL,"1/17/2024 7 a.m. PST",1534,1498,589,-945
SCL,"1/17/2024 8 a.m. PST",1641,1597,684,-957
SCL,"1/17/2024 9 a.m. PST",1677,1615,737,-940
SCL,"1/17/2024 10 a.m. PST",1683,1604,715,-968
SCL,"1/17/2024 11 a.m. PST",1678,1578,789,-889
SCL,"1/17/2024 12 p.m. PST",1680,1562,908,-772
SCL,"1/17/2024 1 p.m. PST",1685,1552,888,-797
SCL,"1/17/2024 2 p.m. PST",1659,1540,931,-728
SCL,"1/17/2024 3 p.m. PST",1642,1529,877,-765
SCL,"1/17/2024 4 p.m. PST",1636,1540,847,-789
SCL,"1/17/2024 5 p.m. PST",1666,1590,793,-873
SCL,"1/17/2024 6 p.m. PST",1706,1654,853,-853
SCL,"1/17/2024 7 p.m. PST",1673,1629,874,-799
SCL,"1/17/2024 8 p.m. PST",1621,1582,617,-1004
SCL,"1/17/2024 9 p.m. PST",1565,1527,593,-972
SCL,"1/17/2024 10 p.m. PST",1481,1441,576,-905
SCL,"1/17/2024 11 p.m. PST",1384,1337,601,-783
SCL,"1/18/2024 12 a.m. PST",1285,1237,552,-733
SCL,"1/18/2024 1 a.m. PST",1219,1247,433,-786
SCL,"1/18/2024 2 a.m. PST",1180,1195,375,-805
SCL,"1/18/2024 3 a.m. PST",1169,1183,368,-801
SCL,"1/18/2024 4 a.m. PST",1184,1188,368,-816
SCL,"1/18/2024 5 a.m. PST",1218,1217,423,-795
SCL,"1/18/2024 6 a.m. PST",1313,1310,417,-896
SCL,"1/18/2024 7 a.m. PST",1452,1442,482,-970
SCL,"1/18/2024 8 a.m. PST",1573,1549,627,-946
SCL,"1/18/2024 9 a.m. PST",1612,1575,717,-895
SCL,"1/18/2024 10 a.m. PST",1614,1568,718,-896
SCL,"1/18/2024 11 a.m. PST",1623,1548,733,-890
SCL,"1/18/2024 12 p.m. PST",1612,1533,854,-758
SCL,"1/18/2024 1 p.m. PST",1618,1524,863,-755
SCL,"1/18/2024 2 p.m. PST",1596,1512,852,-744
SCL,"1/18/2024 3 p.m. PST",1587,1500,802,-785
SCL,"1/18/2024 4 p.m. PST",1584,1510,673,-911
SCL,"1/18/2024 5 p.m. PST",1615,1551,666,-949
SCL,"1/18/2024 6 p.m. PST",1654,1611,686,-968
SCL,"1/18/2024 7 p.m. PST",1623,1587,718,-905
SCL,"1/18/2024 8 p.m. PST",1574,1535,624,-950
SCL,"1/18/2024 9 p.m. PST",1521,1482,535,-986
SCL,"1/18/2024 10 p.m. PST",1451,1401,419,-1032
SCL,"1/18/2024 11 p.m. PST",1348,1302,501,-847
SCL,"1/19/2024 12 a.m. PST",1258,1211,428,-830
SCL,"1/19/2024 1 a.m. PST",1189,1196,341,-848
SCL,"1/19/2024 2 a.m. PST",1147,1161,357,-790
SCL,"1/19/2024 3 a.m. PST",1132,1147,343,-789
SCL,"1/19/2024 4 a.m. PST",1153,1148,362,-791
SCL,"1/19/2024 5 a.m. PST",1194,1174,419,-775
SCL,"1/19/2024 6 a.m. PST",1298,1258,393,-905
SCL,"1/19/2024 7 a.m. PST",1442,1380,468,-974
SCL,"1/19/2024 8 a.m. PST",1570,1478,509,-1061
SCL,"1/19/2024 9 a.m. PST",1597,1498,486,-1111
SCL,"1/19/2024 10 a.m. PST",1593,1486,531,-1062
SCL,"1/19/2024 11 a.m. PST",1565,1454,572,-993
SCL,"1/19/2024 12 p.m. PST",1554,1427,586,-968
SCL,"1/19/2024 1 p.m. PST",1527,1407,584,-943
SCL,"1/19/2024 2 p.m. PST",1508,1378,566,-942
SCL,"1/19/2024 3 p.m. PST",1499,1356,574,-925
SCL,"1/19/2024 4 p.m. PST",1462,1373,567,-895
SCL,"1/19/2024 5 p.m. PST",1476,1421,557,-919
SCL,"1/19/2024 6 p.m. PST",1523,1474,548,-975
SCL,"1/19/2024 7 p.m. PST",1506,1445,527,-979
SCL,"1/19/2024 8 p.m. PST",1466,1394,518,-948
SCL,"1/19/2024 9 p.m. PST",1420,1342,481,-939
SCL,"1/19/2024 10 p.m. PST",1374,1282,447,-927
SCL,"1/19/2024 11 p.m. PST",1305,1214,578,-727
SCL,"1/20/2024 12 a.m. PST",1110,1144,528,-582
SCL,"1/20/2024 1 a.m. PST",1171,1138,475,-696
SCL,"1/20/2024 2 a.m. PST",1134,1099,442,-692
SCL,"1/20/2024 3 a.m. PST",1108,1080,423,-685
SCL,"1/20/2024 4 a.m. PST",1104,1069,412,-692
SCL,"1/20/2024 5 a.m. PST",1117,1065,424,-693
SCL,"1/20/2024 6 a.m. PST",1159,1089,467,-692
SCL,"1/20/2024 7 a.m. PST",1214,1125,423,-791
SCL,"1/20/2024 8 a.m. PST",1288,1179,488,-800
SCL,"1/20/2024 9 a.m. PST",1348,1236,533,-815
SCL,"1/20/2024 10 a.m. PST",1375,1278,553,-822
SCL,"1/20/2024 11 a.m. PST",1358,1288,565,-793
SCL,"1/20/2024 12 p.m. PST",1356,1278,568,-788
SCL,"1/20/2024 1 p.m. PST",1353,1258,517,-836
SCL,"1/20/2024 2 p.m. PST",1292,1226,528,-764
SCL,"1/20/2024 3 p.m. PST",1272,1201,533,-739
SCL,"1/20/2024 4 p.m. PST",1277,1212,501,-776
SCL,"1/20/2024 5 p.m. PST",1328,1257,540,-788
SCL,"1/20/2024 6 p.m. PST",1378,1322,650,-728
SCL,"1/20/2024 7 p.m. PST",1384,1316,668,-716
SCL,"1/20/2024 8 p.m. PST",1356,1283,679,-677
SCL,"1/20/2024 9 p.m. PST",1323,1242,642,-681
SCL,"1/20/2024 10 p.m. PST",1272,1195,506,-766
SCL,"1/20/2024 11 p.m. PST",1216,1139,690,-526
SCL,"1/21/2024 12 a.m. PST",1153,1087,678,-475
SCL,"1/21/2024 1 a.m. PST",1117,1064,407,-710
SCL,"1/21/2024 2 a.m. PST",1076,1037,378,-698
SCL,"1/21/2024 3 a.m. PST",1044,1016,349,-695
SCL,"1/21/2024 4 a.m. PST",990,1005,342,-648
SCL,"1/21/2024 5 a.m. PST",999,1000,347,-652
SCL,"1/21/2024 6 a.m. PST",1053,1013,361,-692
SCL,"1/21/2024 7 a.m. PST",1097,1037,446,-651
SCL,"1/21/2024 8 a.m. PST",1174,1075,493,-681
SCL,"1/21/2024 9 a.m. PST",1230,1126,551,-679
SCL,"1/21/2024 10 a.m. PST",1275,1183,594,-681
SCL,"1/21/2024 11 a.m. PST",1314,1213,613,-701
SCL,"1/21/2024 12 p.m. PST",1333,1222,608,-725
SCL,"1/21/2024 1 p.m. PST",1360,1221,625,-735
SCL,"1/21/2024 2 p.m. PST",1367,1219,623,-744
SCL,"1/21/2024 3 p.m. PST",1338,1213,621,-717
SCL,"1/21/2024 4 p.m. PST",1344,1222,643,-701
SCL,"1/21/2024 5 p.m. PST",1372,1270,661,-711
SCL,"1/21/2024 6 p.m. PST",1419,1333,747,-672
SCL,"1/21/2024 7 p.m. PST",1428,1330,729,-699
SCL,"1/21/2024 8 p.m. PST",1400,1305,624,-776
SCL,"1/21/2024 9 p.m. PST",1362,1262,663,-699
SCL,"1/21/2024 10 p.m. PST",1295,1201,596,-699
SCL,"1/21/2024 11 p.m. PST",1219,1122,468,-751
SCL,"1/22/2024 12 a.m. PST",1125,1043,322,-803
SCL,"1/22/2024 1 a.m. PST",1070,1037,349,-721
SCL,"1/22/2024 2 a.m. PST",1045,997,299,-746
SCL,"1/22/2024 3 a.m. PST",1026,985,257,-769
SCL,"1/22/2024 4 a.m. PST",1044,994,269,-775
SCL,"1/22/2024 5 a.m. PST",1087,1033,331,-756
SCL,"1/22/2024 6 a.m. PST",1182,1129,403,-779
SCL,"1/22/2024 7 a.m. PST",1279,1251,332,-947
SCL,"1/22/2024 8 a.m. PST",1370,1352,394,-976
SCL,"1/22/2024 9 a.m. PST",1428,1377,441,-987
SCL,"1/22/2024 10 a.m. PST",1439,1366,444,-995
SCL,"1/22/2024 11 a.m. PST",1443,1352,425,-1018
SCL,"1/22/2024 12 p.m. PST",1446,1340,404,-1042
SCL,"1/22/2024 1 p.m. PST",1450,1332,437,-1013
SCL,"1/22/2024 2 p.m. PST",1435,1311,439,-996
SCL,"1/22/2024 3 p.m. PST",1405,1289,413,-992
SCL,"1/22/2024 4 p.m. PST",1363,1283,411,-952
SCL,"1/22/2024 5 p.m. PST",1393,1328,480,-913
SCL,"1/22/2024 6 p.m. PST",1449,1399,548,-901
SCL,"1/22/2024 7 p.m. PST",1422,1381,524,-898
SCL,"1/22/2024 8 p.m. PST",1383,1336,451,-932
SCL,"1/22/2024 9 p.m. PST",1332,1283,388,-944
SCL,"1/22/2024 10 p.m. PST",1271,1209,383,-888
SCL,"1/22/2024 11 p.m. PST",1177,1117,411,-766
SCL,"1/23/2024 12 a.m. PST",1084,1034,367,-717
SCL,"1/23/2024 1 a.m. PST",1035,993,315,-720
SCL,"1/23/2024 2 a.m. PST",988,953,263,-725
SCL,"1/23/2024 3 a.m. PST",978,936,252,-726
SCL,"1/23/2024 4 a.m. PST",970,938,254,-716
SCL,"1/23/2024 5 a.m. PST",1019,971,291,-728
SCL,"1/23/2024 6 a.m. PST",1117,1059,323,-794
SCL,"1/23/2024 7 a.m. PST",1260,1182,344,-916
SCL,"1/23/2024 8 a.m. PST",1359,1283,470,-889
SCL,"1/23/2024 9 a.m. PST",1393,1298,441,-952
SCL,"1/23/2024 10 a.m. PST",1382,1297,439,-943
SCL,"1/23/2024 11 a.m. PST",1348,1288,433,-915
SCL,"1/23/2024 12 p.m. PST",1293,1282,399,-894
SCL,"1/23/2024 1 p.m. PST",1261,1279,412,-849
SCL,"1/23/2024 2 p.m. PST",1229,1270,424,-805
SCL,"1/23/2024 3 p.m. PST",1220,1257,464,-756
SCL,"1/23/2024 4 p.m. PST",1247,1263,475,-772
SCL,"1/23/2024 5 p.m. PST",1294,1307,637,-657
SCL,"1/23/2024 6 p.m. PST",1370,1369,691,-679
SCL,"1/23/2024 7 p.m. PST",1374,1358,682,-692
SCL,"1/23/2024 8 p.m. PST",1343,1322,667,-676
SCL,"1/23/2024 9 p.m. PST",1308,1271,650,-658
SCL,"1/23/2024 10 p.m. PST",1260,1203,654,-606
SCL,"1/23/2024 11 p.m. PST",1155,1117,485,-670
SCL,"1/24/2024 12 a.m. PST",1095,1035,410,-685
SCL,"1/24/2024 1 a.m. PST",1036,1007,321,-715
SCL,"1/24/2024 2 a.m. PST",997,970,329,-668
SCL,"1/24/2024 3 a.m. PST",987,956,339,-648
SCL,"1/24/2024 4 a.m. PST",989,961,334,-655
SCL,"1/24/2024 5 a.m. PST",1027,996,326,-701
SCL,"1/24/2024 6 a.m. PST",1131,1089,342,-789
SCL,"1/24/2024 7 a.m. PST",1267,1219,311,-956
SCL,"1/24/2024 8 a.m. PST",1397,1322,411,-986
SCL,"1/24/2024 9 a.m. PST",1442,1338,473,-969
SCL,"1/24/2024 10 a.m. PST",1412,1331,599,-813
SCL,"1/24/2024 11 a.m. PST",1413,1322,565,-848
SCL,"1/24/2024 12 p.m. PST",1373,1314,542,-831
SCL,"1/24/2024 1 p.m. PST",1344,1313,557,-787
SCL,"1/24/2024 2 p.m. PST",1341,1296,457,-884
SCL,"1/24/2024 3 p.m. PST",1335,1272,445,-890
SCL,"1/24/2024 4 p.m. PST",1336,1254,477,-859
SCL,"1/24/2024 5 p.m. PST",1355,1300,583,-772
SCL,"1/24/2024 6 p.m. PST",1411,1364,590,-821
SCL,"1/24/2024 7 p.m. PST",1390,1354,552,-838
SCL,"1/24/2024 8 p.m. PST",1374,1314,515,-859
SCL,"1/24/2024 9 p.m. PST",1333,1268,567,-766
SCL,"1/24/2024 10 p.m. PST",1271,1201,593,-678
SCL,"1/24/2024 11 p.m. PST",1185,1113,513,-672
SCL,"1/25/2024 12 a.m. PST",1110,1038,437,-673
SCL,"1/25/2024 1 a.m. PST",1010,1006,464,-546
SCL,"1/25/2024 2 a.m. PST",961,973,420,-541
SCL,"1/25/2024 3 a.m. PST",947,958,405,-542
SCL,"1/25/2024 4 a.m. PST",958,960,408,-550
SCL,"1/25/2024 5 a.m. PST",996,992,440,-556
SCL,"1/25/2024 6 a.m. PST",1086,1082,481,-605
SCL,"1/25/2024 7 a.m. PST",1239,1211,347,-892
SCL,"1/25/2024 8 a.m. PST",1343,1313,508,-835
SCL,"1/25/2024 9 a.m. PST",1357,1329,632,-725
SCL,"1/25/2024 10 a.m. PST",1334,1326,633,-701
SCL,"1/25/2024 11 a.m. PST",1316,1313,572,-744
SCL,"1/25/2024 12 p.m. PST",1284,1304,534,-750
SCL,"1/25/2024 1 p.m. PST",1282,1302,443,-839
SCL,"1/25/2024 2 p.m. PST",1261,1285,456,-805
SCL,"1/25/2024 3 p.m. PST",1247,1270,438,-809
SCL,"1/25/2024 4 p.m. PST",1253,1260,469,-784
SCL,"1/25/2024 5 p.m. PST",1281,1313,480,-801
SCL,"1/25/2024 6 p.m. PST",1339,1366,533,-806
SCL,"1/25/2024 7 p.m. PST",1328,1354,580,-748
SCL,"1/25/2024 8 p.m. PST",1295,1314,598,-697
SCL,"1/25/2024 9 p.m. PST",1255,1261,638,-617
SCL,"1/25/2024 10 p.m. PST",1195,1195,537,-658
SCL,"1/25/2024 11 p.m. PST",1115,1110,530,-585
SCL,"1/26/2024 12 a.m. PST",1033,1036,489,-544
SCL,"1/26/2024 1 a.m. PST",984,983,378,-606
SCL,"1/26/2024 2 a.m. PST",938,950,340,-598
SCL,"1/26/2024 3 a.m. PST",921,936,303,-618
SCL,"1/26/2024 4 a.m. PST",930,942,310,-620
SCL,"1/26/2024 5 a.m. PST",985,984,417,-568
SCL,"1/26/2024 6 a.m. PST",1079,1079,475,-604
SCL,"1/26/2024 7 a.m. PST",1238,1204,521,-717
SCL,"1/26/2024 8 a.m. PST",1353,1308,575,-778
SCL,"1/26/2024 9 a.m. PST",1358,1332,563,-795
SCL,"1/26/2024 10 a.m. PST",1367,1327,622,-745
SCL,"1/26/2024 11 a.m. PST",1354,1307,596,-758
SCL,"1/26/2024 12 p.m. PST",1319,1295,567,-752
SCL,"1/26/2024 1 p.m. PST",1323,1289,571,-752
SCL,"1/26/2024 2 p.m. PST",1301,1265,566,-735
SCL,"1/26/2024 3 p.m. PST",1310,1242,570,-740
SCL,"1/26/2024 4 p.m. PST",1318,1255,576,-742
SCL,"1/26/2024 5 p.m. PST",1318,1298,600,-718
SCL,"1/26/2024 6 p.m. PST",1358,1347,454,-904
SCL,"1/26/2024 7 p.m. PST",1318,1327,446,-872
SCL,"1/26/2024 8 p.m. PST",1293,1274,417,-876
SCL,"1/26/2024 9 p.m. PST",1247,1219,478,-769
SCL,"1/26/2024 10 p.m. PST",1209,1164,489,-720
SCL,"1/26/2024 11 p.m. PST",1133,1096,496,-637
SCL,"1/27/2024 12 a.m. PST",1070,1030,413,-657
SCL,"1/27/2024 1 a.m. PST",1014,984,364,-650
SCL,"1/27/2024 2 a.m. PST",971,944,321,-650
SCL,"1/27/2024 3 a.m. PST",942,922,289,-653
SCL,"1/27/2024 4 a.m. PST",932,911,289,-643
SCL,"1/27/2024 5 a.m. PST",940,916,273,-667
SCL,"1/27/2024 6 a.m. PST",972,942,339,-633
SCL,"1/27/2024 7 a.m. PST",1027,979,285,-742
SCL,"1/27/2024 8 a.m. PST",1101,1030,390,-711
SCL,"1/27/2024 9 a.m. PST",1148,1090,366,-782
SCL,"1/27/2024 10 a.m. PST",1202,1146,400,-802
SCL,"1/27/2024 11 a.m. PST",1230,1170,399,-831
SCL,"1/27/2024 12 p.m. PST",1236,1174,397,-839
SCL,"1/27/2024 1 p.m. PST",1239,1162,399,-840
SCL,"1/27/2024 2 p.m. PST",1200,1143,364,-836
SCL,"1/27/2024 3 p.m. PST",1196,1127,406,-790
SCL,"1/27/2024 4 p.m. PST",1192,1125,445,-747
SCL,"1/27/2024 5 p.m. PST",1210,1162,547,-663
SCL,"1/27/2024 6 p.m. PST",1256,1219,560,-696
SCL,"1/27/2024 7 p.m. PST",1231,1211,533,-698
SCL,"1/27/2024 8 p.m. PST",1201,1172,428,-773
SCL,"1/27/2024 9 p.m. PST",1134,1129,412,-722
SCL,"1/27/2024 10 p.m. PST",1127,1084,413,-714
SCL,"1/27/2024 11 p.m. PST",1074,1026,443,-631
SCL,"1/28/2024 12 a.m. PST",1000,967,349,-651
SCL,"1/28/2024 1 a.m. PST",968,922,266,-702
SCL,"1/28/2024 2 a.m. PST",929,881,216,-713
SCL,"1/28/2024 3 a.m. PST",899,856,206,-693
SCL,"1/28/2024 4 a.m. PST",897,842,195,-702
SCL,"1/28/2024 5 a.m. PST",902,840,224,-678
SCL,"1/28/2024 6 a.m. PST",927,856,242,-685
SCL,"1/28/2024 7 a.m. PST",963,888,317,-646
SCL,"1/28/2024 8 a.m. PST",1006,931,375,-631
SCL,"1/28/2024 9 a.m. PST",1054,983,379,-675
SCL,"1/28/2024 10 a.m. PST",1078,1045,382,-696
SCL,"1/28/2024 11 a.m. PST",1108,1087,396,-712
SCL,"1/28/2024 12 p.m. PST",1128,1113,398,-730
SCL,"1/28/2024 1 p.m. PST",1143,1125,455,-688
SCL,"1/28/2024 2 p.m. PST",1139,1124,465,-674
SCL,"1/28/2024 3 p.m. PST",1140,1117,454,-686
SCL,"1/28/2024 4 p.m. PST",1149,1127,493,-656
SCL,"1/28/2024 5 p.m. PST",1156,1164,571,-585
SCL,"1/28/2024 6 p.m. PST",1228,1221,616,-612
SCL,"1/28/2024 7 p.m. PST",1225,1217,591,-634
SCL,"1/28/2024 8 p.m. PST",1204,1188,513,-691
SCL,"1/28/2024 9 p.m. PST",1149,1145,505,-644
SCL,"1/28/2024 10 p.m. PST",1073,1087,442,-631
SCL,"1/28/2024 11 p.m. PST",999,1012,379,-620
SCL,"1/29/2024 12 a.m. PST",915,942,277,-638
SCL,"1/29/2024 1 a.m. PST",866,872,241,-625
SCL,"1/29/2024 2 a.m. PST",834,838,267,-567
SCL,"1/29/2024 3 a.m. PST",811,822,237,-574
SCL,"1/29/2024 4 a.m. PST",825,827,221,-604
SCL,"1/29/2024 5 a.m. PST",904,865,224,-680
SCL,"1/29/2024 6 a.m. PST",986,956,281,-705
SCL,"1/29/2024 7 a.m. PST",1112,1085,351,-761
SCL,"1/29/2024 8 a.m. PST",1215,1198,287,-928
SCL,"1/29/2024 9 a.m. PST",1240,1229,402,-838
SCL,"1/29/2024 10 a.m. PST",1243,1229,462,-781
SCL,"1/29/2024 11 a.m. PST",1235,1229,530,-705
SCL,"1/29/2024 12 p.m. PST",1238,1236,478,-760
SCL,"1/29/2024 1 p.m. PST",1212,1241,496,-716
SCL,"1/29/2024 2 p.m. PST",1196,1235,462,-734
SCL,"1/29/2024 3 p.m. PST",1195,1219,375,-820
SCL,"1/29/2024 4 p.m. PST",1181,1219,418,-763
SCL,"1/29/2024 5 p.m. PST",1206,1254,513,-693
SCL,"1/29/2024 6 p.m. PST",1273,1313,438,-835
SCL,"1/29/2024 7 p.m. PST",1262,1298,419,-843
SCL,"1/29/2024 8 p.m. PST",1234,1253,450,-784
SCL,"1/29/2024 9 p.m. PST",1183,1197,455,-728
SCL,"1/29/2024 10 p.m. PST",1148,1131,420,-728
SCL,"1/29/2024 11 p.m. PST",1060,1040,436,-624
SCL,"1/30/2024 12 a.m. PST",977,954,351,-626
SCL,"1/30/2024 1 a.m. PST",914,869,322,-592
SCL,"1/30/2024 2 a.m. PST",874,838,318,-556
SCL,"1/30/2024 3 a.m. PST",851,819,300,-551
SCL,"1/30/2024 4 a.m. PST",858,818,298,-560
SCL,"1/30/2024 5 a.m. PST",883,847,338,-545
SCL,"1/30/2024 6 a.m. PST",951,933,424,-527
SCL,"1/30/2024 7 a.m. PST",1076,1059,434,-642
SCL,"1/30/2024 8 a.m. PST",1176,1168,620,-556
SCL,"1/30/2024 9 a.m. PST",1197,1195,643,-554
SCL,"1/30/2024 10 a.m. PST",1204,1197,684,-520
SCL,"1/30/2024 11 a.m. PST",1222,1196,616,-606
SCL,"1/30/2024 12 p.m. PST",1225,1199,602,-623
SCL,"1/30/2024 1 p.m. PST",1205,1206,608,-597
SCL,"1/30/2024 2 p.m. PST",1217,1200,593,-624
SCL,"1/30/2024 3 p.m. PST",1189,1186,620,-569
SCL,"1/30/2024 4 p.m. PST",1182,1190,654,-528
SCL,"1/30/2024 5 p.m. PST",1230,1225,723,-507
SCL,"1/30/2024 6 p.m. PST",1275,1279,656,-619
SCL,"1/30/2024 7 p.m. PST",1278,1268,687,-591
SCL,"1/30/2024 8 p.m. PST",1254,1228,600,-654
SCL,"1/30/2024 9 p.m. PST",1206,1177,541,-665
SCL,"1/30/2024 10 p.m. PST",1151,1111,510,-641
SCL,"1/30/2024 11 p.m. PST",1065,1024,500,-565
SCL,"1/31/2024 12 a.m. PST",983,945,418,-565
SCL,"1/31/2024 1 a.m. PST",918,876,462,-456
SCL,"1/31/2024 2 a.m. PST",885,838,441,-444
SCL,"1/31/2024 3 a.m. PST",864,818,420,-444
SCL,"1/31/2024 4 a.m. PST",867,816,428,-439
SCL,"1/31/2024 5 a.m. PST",899,847,447,-452
SCL,"1/31/2024 6 a.m. PST",971,932,451,-520
SCL,"1/31/2024 7 a.m. PST",1105,1055,443,-662
SCL,"1/31/2024 8 a.m. PST",1207,1162,512,-695
SCL,"1/31/2024 9 a.m. PST",1242,1189,601,-641
SCL,"1/31/2024 10 a.m. PST",1239,1192,569,-670
SCL,"1/31/2024 11 a.m. PST",1245,1194,525,-720
SCL,"1/31/2024 12 p.m. PST",1244,1192,608,-636
SCL,"1/31/2024 1 p.m. PST",1201,1197,653,-548
SCL,"1/31/2024 2 p.m. PST",1188,1192,588,-600
SCL,"1/31/2024 3 p.m. PST",1172,1180,525,-647
SCL,"1/31/2024 4 p.m. PST",1176,1184,600,-576
SCL,"1/31/2024 5 p.m. PST",1198,1219,623,-575
SCL,"1/31/2024 6 p.m. PST",1248,1270,569,-679
SCL,"1/31/2024 7 p.m. PST",1231,1266,599,-632
SCL,"1/31/2024 8 p.m. PST",1209,1227,480,-729
SCL,"1/31/2024 9 p.m. PST",1171,1177,436,-735
SCL,"1/31/2024 10 p.m. PST",1123,1112,442,-681
SCL,"1/31/2024 11 p.m. PST",1045,1026,466,-579