"BA Code","Timestamp (Hour Ending)","Demand (MWh)","Demand Forecast (MWh)","Net Generation (MWh)","Total Interchange (MWh)"
SCL,"3/1/2025 12 a.m. PST",1001,986,458,-543
SCL,"3/1/2025 1 a.m. PST",957,931,371,-586
SCL,"3/1/2025 2 a.m. PST",941,897,368,-573
SCL,"3/1/2025 3 a.m. PST",929,880,324,-605
SCL,"3/1/2025 4 a.m. PST",919,879,330,-589
SCL,"3/1/2025 5 a.m. PST",920,902,412,-508
SCL,"3/1/2025 6 a.m. PST",982,954,421,-561
SCL,"3/1/2025 7 a.m. PST",1049,1024,383,-666
SCL,"3/1/2025 8 a.m. PST",1106,1086,400,-706
SCL,"3/1/2025 9 a.m. PST",1175,1130,419,-756
SCL,"3/1/2025 10 a.m. PST",1189,1141,301,-888
SCL,"3/1/2025 11 a.m. PST",1119,1129,277,-842
SCL,"3/1/2025 12 p.m. PST",1086,1104,178,-908
SCL,"3/1/2025 1 p.m. PST",1095,1072,180,-915
SCL,"3/1/2025 2 p.m. PST",1066,1040,177,-889
SCL,"3/1/2025 3 p.m. PST",1059,1026,147,-912
SCL,"3/1/2025 4 p.m. PST",1047,1020,280,-767
SCL,"3/1/2025 5 p.m. PST",1084,1045,494,-590
SCL,"3/1/2025 6 p.m. PST",1127,1090,636,-491
SCL,"3/1/2025 7 p.m. PST",1161,1137,616,-545
SCL,"3/1/2025 8 p.m. PST",1150,1135,577,-573
SCL,"3/1/2025 9 p.m. PST",1137,1116,557,-580
SCL,"3/1/2025 10 p.m. PST",1103,1086,384,-719
SCL,"3/1/2025 11 p.m. PST",1046,1045,564,-482
SCL,"3/2/2025 12 a.m. PST",1013,990,466,-547
SCL,"3/2/2025 1 a.m. PST",962,918,458,-504
SCL,"3/2/2025 2 a.m. PST",929,891,426,-503
SCL,"3/2/2025 3 a.m. PST",900,872,400,-500
SCL,"3/2/2025 4 a.m. PST",890,867,390,-500
SCL,"3/2/2025 5 a.m. PST",905,878,393,-512
SCL,"3/2/2025 6 a.m. PST",931,909,433,-498
SCL,"3/2/2025 7 a.m. PST",971,964,366,-605
SCL,"3/2/2025 8 a.m. PST",1026,1008,375,-651
SCL,"3/2/2025 9 a.m. PST",1066,1051,404,-662
SCL,"3/2/2025 10 a.m. PST",1106,1075,477,-629
SCL,"3/2/2025 11 a.m. PST",1136,1091,398,-738
SCL,"3/2/2025 12 p.m. PST",1169,1091,386,-783
SCL,"3/2/2025 1 p.m. PST",1178,1101,398,-780
SCL,"3/2/2025 2 p.m. PST",1176,1096,397,-779
SCL,"3/2/2025 3 p.m. PST",1166,1098,300,-866
SCL,"3/2/2025 4 p.m. PST",1151,1097,298,-853
SCL,"3/2/2025 5 p.m. PST",1147,1123,334,-813
SCL,"3/2/2025 6 p.m. PST",1196,1177,346,-850
SCL,"3/2/2025 7 p.m. PST",1266,1230,320,-946
SCL,"3/2/2025 8 p.m. PST",1257,1214,317,-940
SCL,"3/2/2025 9 p.m. PST",1231,1189,486,-745
SCL,"3/2/2025 10 p.m. PST",1163,1146,468,-695
SCL,"3/2/2025 11 p.m. PST",1100,1069,419,-681
SCL,"3/3/2025 12 a.m. PST",1016,988,439,-577
SCL,"3/3/2025 1 a.m. PST",961,926,471,-490
SCL,"3/3/2025 2 a.m. PST",928,886,420,-508
SCL,"3/3/2025 3 a.m. PST",908,876,408,-500
SCL,"3/3/2025 4 a.m. PST",915,887,382,-533
SCL,"3/3/2025 5 a.m. PST",962,932,445,-517
SCL,"3/3/2025 6 a.m. PST",1052,1029,471,-581
SCL,"3/3/2025 7 a.m. PST",1180,1170,415,-765
SCL,"3/3/2025 8 a.m. PST",1303,1270,558,-745
SCL,"3/3/2025 9 a.m. PST",1331,1296,508,-823
SCL,"3/3/2025 10 a.m. PST",1327,1280,395,-932
SCL,"3/3/2025 11 a.m. PST",1277,1259,304,-973
SCL,"3/3/2025 12 p.m. PST",1281,1244,293,-988
SCL,"3/3/2025 1 p.m. PST",1273,1232,284,-989
SCL,"3/3/2025 2 p.m. PST",1257,1223,288,-969
SCL,"3/3/2025 3 p.m. PST",1229,1197,304,-925
SCL,"3/3/2025 4 p.m. PST",1229,1183,305,-924
SCL,"3/3/2025 5 p.m. PST",1252,1208,622,-630
SCL,"3/3/2025 6 p.m. PST",1305,1253,650,-655
SCL,"3/3/2025 7 p.m. PST",1330,1290,625,-705
SCL,"3/3/2025 8 p.m. PST",1304,1268,614,-690
SCL,"3/3/2025 9 p.m. PST",1267,1233,613,-654
SCL,"3/3/2025 10 p.m. PST",1201,1173,607,-594
SCL,"3/3/2025 11 p.m. PST",1122,1098,504,-618
SCL,"3/4/2025 12 a.m. PST",1044,1016,514,-530
SCL,"3/4/2025 1 a.m. PST",996,958,351,-645
SCL,"3/4/2025 2 a.m. PST",961,921,347,-614
SCL,"3/4/2025 3 a.m. PST",945,908,353,-592
SCL,"3/4/2025 4 a.m. PST",952,917,340,-612
SCL,"3/4/2025 5 a.m. PST",987,961,356,-631
SCL,"3/4/2025 6 a.m. PST",1085,1064,496,-589
SCL,"3/4/2025 7 a.m. PST",1222,1217,418,-804
SCL,"3/4/2025 8 a.m. PST",1321,1321,522,-799
SCL,"3/4/2025 9 a.m. PST",1327,1330,477,-850
SCL,"3/4/2025 10 a.m. PST",1333,1301,476,-857
SCL,"3/4/2025 11 a.m. PST",1339,1263,371,-968
SCL,"3/4/2025 12 p.m. PST",1334,1234,206,-1128
SCL,"3/4/2025 1 p.m. PST",1324,1221,227,-1097
SCL,"3/4/2025 2 p.m. PST",1342,1214,228,-1114
SCL,"3/4/2025 3 p.m. PST",1344,1194,266,-1078
SCL,"3/4/2025 4 p.m. PST",1297,1189,294,-1003
SCL,"3/4/2025 5 p.m. PST",1269,1216,351,-918
SCL,"3/4/2025 6 p.m. PST",1319,1262,544,-775
SCL,"3/4/2025 7 p.m. PST",1379,1300,684,-695
SCL,"3/4/2025 8 p.m. PST",1381,1286,678,-703
SCL,"3/4/2025 9 p.m. PST",1343,1250,643,-700
SCL,"3/4/2025 10 p.m. PST",1251,1199,542,-709
SCL,"3/4/2025 11 p.m. PST",1143,1117,514,-629
SCL,"3/5/2025 12 a.m. PST",1058,1040,519,-539
SCL,"3/5/2025 1 a.m. PST",997,1008,329,-668
SCL,"3/5/2025 2 a.m. PST",955,973,277,-678
SCL,"3/5/2025 3 a.m. PST",946,960,221,-725
SCL,"3/5/2025 4 a.m. PST",954,965,240,-714
SCL,"3/5/2025 5 a.m. PST",992,1003,296,-696
SCL,"3/5/2025 6 a.m. PST",1100,1100,492,-608
SCL,"3/5/2025 7 a.m. PST",1256,1242,632,-624
SCL,"3/5/2025 8 a.m. PST",1346,1334,746,-600
SCL,"3/5/2025 9 a.m. PST",1325,1340,714,-611
SCL,"3/5/2025 10 a.m. PST",1273,1300,553,-720
SCL,"3/5/2025 11 a.m. PST",1223,1252,420,-803
SCL,"3/5/2025 12 p.m. PST",1195,1211,267,-928
SCL,"3/5/2025 1 p.m. PST",1179,1187,333,-846
SCL,"3/5/2025 2 p.m. PST",1150,1170,346,-804
SCL,"3/5/2025 3 p.m. PST",1119,1161,334,-785
SCL,"3/5/2025 4 p.m. PST",1118,1159,339,-779
SCL,"3/5/2025 5 p.m. PST",1139,1177,489,-650
SCL,"3/5/2025 6 p.m. PST",1203,1225,672,-531
SCL,"3/5/2025 7 p.m. PST",1253,1272,603,-650
SCL,"3/5/2025 8 p.m. PST",1254,1267,563,-691
SCL,"3/5/2025 9 p.m. PST",1235,1240,721,-514
SCL,"3/5/2025 10 p.m. PST",1182,1190,576,-606
SCL,"3/5/2025 11 p.m. PST",1108,1116,471,-637
SCL,"3/6/2025 12 a.m. PST",1023,1041,288,-735
SCL,"3/6/2025 1 a.m. PST",972,986,288,-684
SCL,"3/6/2025 2 a.m. PST",937,950,265,-672
SCL,"3/6/2025 3 a.m. PST",923,940,215,-708
SCL,"3/6/2025 4 a.m. PST",929,950,218,-711
SCL,"3/6/2025 5 a.m. PST",968,998,263,-705
SCL,"3/6/2025 6 a.m. PST",1066,1104,525,-541
SCL,"3/6/2025 7 a.m. PST",1211,1258,664,-547
SCL,"3/6/2025 8 a.m. PST",1310,1363,620,-690
SCL,"3/6/2025 9 a.m. PST",1332,1369,528,-804
SCL,"3/6/2025 10 a.m. PST",1330,1328,517,-813
SCL,"3/6/2025 11 a.m. PST",1302,1288,462,-840
SCL,"3/6/2025 12 p.m. PST",1265,1250,284,-981
SCL,"3/6/2025 1 p.m. PST",1205,1220,325,-880
SCL,"3/6/2025 2 p.m. PST",1158,1194,307,-851
SCL,"3/6/2025 3 p.m. PST",1125,1172,304,-821
SCL,"3/6/2025 4 p.m. PST",1114,1160,324,-790
SCL,"3/6/2025 5 p.m. PST",1137,1178,500,-637
SCL,"3/6/2025 6 p.m. PST",1181,1224,674,-507
SCL,"3/6/2025 7 p.m. PST",1231,1270,616,-615
SCL,"3/6/2025 8 p.m. PST",1241,1261,618,-623
SCL,"3/6/2025 9 p.m. PST",1216,1243,618,-598
SCL,"3/6/2025 10 p.m. PST",1179,1201,597,-582
SCL,"3/6/2025 11 p.m. PST",1099,1130,507,-592
SCL,"3/7/2025 12 a.m. PST",1029,1059,334,-695
SCL,"3/7/2025 1 a.m. PST",976,982,264,-712
SCL,"3/7/2025 2 a.m. PST",954,951,207,-747
SCL,"3/7/2025 3 a.m. PST",946,940,207,-739
SCL,"3/7/2025 4 a.m. PST",956,949,205,-751
SCL,"3/7/2025 5 a.m. PST",1001,996,277,-724
SCL,"3/7/2025 6 a.m. PST",1093,1100,522,-571
SCL,"3/7/2025 7 a.m. PST",1233,1246,571,-662
SCL,"3/7/2025 8 a.m. PST",1334,1352,613,-721
SCL,"3/7/2025 9 a.m. PST",1391,1363,530,-861
SCL,"3/7/2025 10 a.m. PST",1393,1328,290,-1103
SCL,"3/7/2025 11 a.m. PST",1383,1290,287,-1096
SCL,"3/7/2025 12 p.m. PST",1341,1263,282,-1059
SCL,"3/7/2025 1 p.m. PST",1271,1235,316,-955
SCL,"3/7/2025 2 p.m. PST",1229,1207,343,-886
SCL,"3/7/2025 3 p.m. PST",1206,1183,318,-888
SCL,"3/7/2025 4 p.m. PST",1218,1165,286,-932
SCL,"3/7/2025 5 p.m. PST",1242,1178,313,-929
SCL,"3/7/2025 6 p.m. PST",1273,1211,629,-644
SCL,"3/7/2025 7 p.m. PST",1298,1242,595,-703
SCL,"3/7/2025 8 p.m. PST",1280,1226,571,-709
SCL,"3/7/2025 9 p.m. PST",1240,1200,422,-818
SCL,"3/7/2025 10 p.m. PST",1192,1159,414,-778
SCL,"3/7/2025 11 p.m. PST",1127,1104,305,-822
SCL,"3/8/2025 12 a.m. PST",1072,1042,316,-756
SCL,"3/8/2025 1 a.m. PST",1010,980,271,-739
SCL,"3/8/2025 2 a.m. PST",976,936,255,-721
SCL,"3/8/2025 3 a.m. PST",948,916,259,-689
SCL,"3/8/2025 4 a.m. PST",944,911,226,-718
SCL,"3/8/2025 5 a.m. PST",957,925,223,-734
SCL,"3/8/2025 6 a.m. PST",989,964,501,-488
SCL,"3/8/2025 7 a.m. PST",1048,1023,529,-519
SCL,"3/8/2025 8 a.m. PST",1116,1081,488,-628
SCL,"3/8/2025 9 a.m. PST",1180,1123,486,-694
SCL,"3/8/2025 10 a.m. PST",1207,1140,320,-887
SCL,"3/8/2025 11 a.m. PST",1222,1127,346,-876
SCL,"3/8/2025 12 p.m. PST",1225,1101,359,-866
SCL,"3/8/2025 1 p.m. PST",1221,1073,329,-892
SCL,"3/8/2025 2 p.m. PST",1196,1037,302,-894
SCL,"3/8/2025 3 p.m. PST",1347,1024,427,-920
SCL,"3/8/2025 4 p.m. PST",1185,1020,293,-892
SCL,"3/8/2025 5 p.m. PST",1212,1047,383,-829
SCL,"3/8/2025 6 p.m. PST",1236,1083,519,-717
SCL,"3/8/2025 7 p.m. PST",1246,1134,583,-663
SCL,"3/8/2025 8 p.m. PST",1222,1131,486,-736
SCL,"3/8/2025 9 p.m. PST",1182,1111,597,-585
SCL,"3/8/2025 10 p.m. PST",1120,1077,488,-632
SCL,"3/8/2025 11 p.m. PST",1079,1036,487,-592
SCL,"3/9/2025 12 a.m. PST",1025,985,472,-553
SCL,"3/9/2025 1 a.m. PST",975,941,265,-710
SCL,"3/9/2025 3 a.m. PDT",942,867,266,-676
SCL,"3/9/2025 4 a.m. PDT",922,871,221,-701
SCL,"3/9/2025 5 a.m. PDT",920,894,212,-708
SCL,"3/9/2025 6 a.m. PDT",938,942,274,-664
SCL,"3/9/2025 7 a.m. PDT",978,995,323,-655
SCL,"3/9/2025 8 a.m. PDT",1023,1033,324,-699
SCL,"3/9/2025 9 a.m. PDT",1080,1066,300,-780
SCL,"3/9/2025 10 a.m. PDT",1105,1092,184,-921
SCL,"3/9/2025 11 a.m. PDT",1114,1085,182,-932
SCL,"3/9/2025 12 p.m. PDT",1128,1082,223,-905
SCL,"3/9/2025 1 p.m. PDT",1153,1073,156,-997
SCL,"3/9/2025 2 p.m. PDT",1152,1073,134,-1018
SCL,"3/9/2025 3 p.m. PDT",1159,1080,145,-1014
SCL,"3/9/2025 4 p.m. PDT",1175,1105,153,-1022
SCL,"3/9/2025 5 p.m. PDT",1207,1142,222,-985
SCL,"3/9/2025 6 p.m. PDT",1278,1182,427,-851
SCL,"3/9/2025 7 p.m. PDT",1316,1221,671,-645
SCL,"3/9/2025 8 p.m. PDT",1340,1219,670,-670
SCL,"3/9/2025 9 p.m. PDT",1323,1168,618,-705
SCL,"3/9/2025 10 p.m. PDT",1277,1093,588,-689
SCL,"3/9/2025 11 p.m. PDT",1211,1005,504,-707
SCL,"3/10/2025 12 a.m. PDT",1126,,516,-610
SCL,"3/10/2025 1 a.m. PDT",1051,1032,245,-806
SCL,"3/10/2025 2 a.m. PDT",1008,1003,246,-762
SCL,"3/10/2025 3 a.m. PDT",984,994,245,-739
SCL,"3/10/2025 4 a.m. PDT",997,1003,246,-751
SCL,"3/10/2025 5 a.m. PDT",1005,1035,297,-708
SCL,"3/10/2025 6 a.m. PDT",1152,1117,476,-676
SCL,"3/10/2025 7 a.m. PDT",1248,1245,673,-575
SCL,"3/10/2025 8 a.m. PDT",1412,1351,744,-668
SCL,"3/10/2025 9 a.m. PDT",1440,1363,594,-846
SCL,"3/10/2025 10 a.m. PDT",1354,1358,563,-791
SCL,"3/10/2025 11 a.m. PDT",1325,1343,436,-889
SCL,"3/10/2025 12 p.m. PDT",1370,1324,249,-1121
SCL,"3/10/2025 1 p.m. PDT",1362,1302,248,-1114
SCL,"3/10/2025 2 p.m. PDT",1354,1290,255,-1099
SCL,"3/10/2025 3 p.m. PDT",1325,1259,250,-1075
SCL,"3/10/2025 4 p.m. PDT",1440,1234,386,-1054
SCL,"3/10/2025 5 p.m. PDT",1346,1238,276,-1070
SCL,"3/10/2025 6 p.m. PDT",1376,1247,653,-723
SCL,"3/10/2025 7 p.m. PDT",1382,1264,689,-693
SCL,"3/10/2025 8 p.m. PDT",1395,1291,779,-616
SCL,"3/10/2025 9 p.m. PDT",1373,1272,624,-749
SCL,"3/10/2025 10 p.m. PDT",1318,1213,597,-721
SCL,"3/10/2025 11 p.m. PDT",1209,1135,515,-694
SCL,"3/11/2025 12 a.m. PDT",1118,1049,463,-655
SCL,"3/11/2025 1 a.m. PDT",1066,1018,295,-771
SCL,"3/11/2025 2 a.m. PDT",1022,985,314,-708
SCL,"3/11/2025 3 a.m. PDT",1010,970,302,-708
SCL,"3/11/2025 4 a.m. PDT",1019,977,296,-723
SCL,"3/11/2025 5 a.m. PDT",1069,1016,309,-760
SCL,"3/11/2025 6 a.m. PDT",1160,1109,533,-627
SCL,"3/11/2025 7 a.m. PDT",1313,1253,648,-665
SCL,"3/11/2025 8 a.m. PDT",1424,1371,750,-674
SCL,"3/11/2025 9 a.m. PDT",1441,1384,594,-847
SCL,"3/11/2025 10 a.m. PDT",1426,1362,497,-929
SCL,"3/11/2025 11 a.m. PDT",1392,1328,454,-938
SCL,"3/11/2025 12 p.m. PDT",1377,1292,455,-922
SCL,"3/11/2025 1 p.m. PDT",1347,1264,280,-1067
SCL,"3/11/2025 2 p.m. PDT",1312,1242,272,-1040
SCL,"3/11/2025 3 p.m. PDT",1245,1226,246,-999
SCL,"3/11/2025 4 p.m. PDT",1359,1213,403,-956
SCL,"3/11/2025 5 p.m. PDT",1251,1223,317,-934
SCL,"3/11/2025 6 p.m. PDT",1304,1247,493,-811
SCL,"3/11/2025 7 p.m. PDT",1323,1266,631,-692
SCL,"3/11/2025 8 p.m. PDT",1336,1297,728,-608
SCL,"3/11/2025 9 p.m. PDT",1324,1276,656,-668
SCL,"3/11/2025 10 p.m. PDT",1272,1226,519,-753
SCL,"3/11/2025 11 p.m. PDT",1182,1139,516,-666
SCL,"3/12/2025 12 a.m. PDT",1094,1049,479,-615
SCL,"3/12/2025 1 a.m. PDT",1034,990,356,-678
SCL,"3/12/2025 2 a.m. PDT",989,949,355,-634
SCL,"3/12/2025 3 a.m. PDT",923,933,308,-615
SCL,"3/12/2025 4 a.m. PDT",925,937,284,-641
SCL,"3/12/2025 5 a.m. PDT",965,975,363,-602
SCL,"3/12/2025 6 a.m. PDT",1061,1063,439,-622
SCL,"3/12/2025 7 a.m. PDT",1200,1200,421,-779
SCL,"3/12/2025 8 a.m. PDT",1313,1315,603,-710
SCL,"3/12/2025 9 a.m. PDT",1338,1333,741,-597
SCL,"3/12/2025 10 a.m. PDT",1352,1319,708,-644
SCL,"3/12/2025 11 a.m. PDT",1335,1295,700,-635
SCL,"3/12/2025 12 p.m. PDT",1325,1273,675,-650
SCL,"3/12/2025 1 p.m. PDT",1294,1251,665,-629
SCL,"3/12/2025 2 p.m. PDT",1268,1233,635,-633
SCL,"3/12/2025 3 p.m. PDT",1239,1221,528,-711
SCL,"3/12/2025 4 p.m. PDT",1208,1210,483,-725
SCL,"3/12/2025 5 p.m. PDT",1216,1225,514,-702
SCL,"3/12/2025 6 p.m. PDT",1236,1250,690,-546
SCL,"3/12/2025 7 p.m. PDT",1254,1255,749,-505
SCL,"3/12/2025 8 p.m. PDT",1269,1286,745,-524
SCL,"3/12/2025 9 p.m. PDT",1259,1266,760,-499
SCL,"3/12/2025 10 p.m. PDT",1211,1210,651,-560
SCL,"3/12/2025 11 p.m. PDT",1134,1126,450,-684
SCL,"3/13/2025 12 a.m. PDT",1055,1044,348,-707
SCL,"3/13/2025 1 a.m. PDT",993,996,279,-714
SCL,"3/13/2025 2 a.m. PDT",956,974,304,-652
SCL,"3/13/2025 3 a.m. PDT",936,960,281,-655
SCL,"3/13/2025 4 a.m. PDT",936,966,238,-698
SCL,"3/13/2025 5 a.m. PDT",974,1006,252,-722
SCL,"3/13/2025 6 a.m. PDT",1083,1100,438,-645
SCL,"3/13/2025 7 a.m. PDT",1232,1252,673,-559
SCL,"3/13/2025 8 a.m. PDT",1368,1370,736,-632
SCL,"3/13/2025 9 a.m. PDT",1397,1390,624,-773
SCL,"3/13/2025 10 a.m. PDT",1351,1377,617,-734
SCL,"3/13/2025 11 a.m. PDT",1297,1355,471,-826
SCL,"3/13/2025 12 p.m. PDT",1259,1333,360,-899
SCL,"3/13/2025 1 p.m. PDT",1254,1310,290,-964
SCL,"3/13/2025 2 p.m. PDT",1306,1297,291,-1015
SCL,"3/13/2025 3 p.m. PDT",1287,1290,254,-1033
SCL,"3/13/2025 4 p.m. PDT",1242,1287,244,-998
SCL,"3/13/2025 5 p.m. PDT",1231,1297,384,-847
SCL,"3/13/2025 6 p.m. PDT",1273,1316,548,-725
SCL,"3/13/2025 7 p.m. PDT",1284,1316,713,-571
SCL,"3/13/2025 8 p.m. PDT",1331,1342,782,-549
SCL,"3/13/2025 9 p.m. PDT",1342,1328,690,-652
SCL,"3/13/2025 10 p.m. PDT",1287,1271,683,-604
SCL,"3/13/2025 11 p.m. PDT",1213,1187,770,-443
SCL,"3/14/2025 12 a.m. PDT",1125,1098,670,-455
SCL,"3/14/2025 1 a.m. PDT",1069,1071,339,-730
SCL,"3/14/2025 2 a.m. PDT",1028,1039,320,-708
SCL,"3/14/2025 3 a.m. PDT",1015,1024,331,-684
SCL,"3/14/2025 4 a.m. PDT",1022,1027,313,-709
SCL,"3/14/2025 5 a.m. PDT",1067,1064,479,-588
SCL,"3/14/2025 6 a.m. PDT",1163,1157,647,-516
SCL,"3/14/2025 7 a.m. PDT",1312,1299,762,-550
SCL,"3/14/2025 8 a.m. PDT",1431,1413,782,-649
SCL,"3/14/2025 9 a.m. PDT",1474,1431,776,-698
SCL,"3/14/2025 10 a.m. PDT",1445,1403,500,-945
SCL,"3/14/2025 11 a.m. PDT",1381,1367,441,-940
SCL,"3/14/2025 12 p.m. PDT",1341,1328,430,-911
SCL,"3/14/2025 1 p.m. PDT",1322,1285,417,-905
SCL,"3/14/2025 2 p.m. PDT",1298,1247,416,-882
SCL,"3/14/2025 3 p.m. PDT",1282,1215,411,-871
SCL,"3/14/2025 4 p.m. PDT",1276,1199,315,-961
SCL,"3/14/2025 5 p.m. PDT",1298,1206,293,-1005
SCL,"3/14/2025 6 p.m. PDT",1307,1225,515,-792
SCL,"3/14/2025 7 p.m. PDT",1295,1227,535,-760
SCL,"3/14/2025 8 p.m. PDT",1307,1251,517,-790
SCL,"3/14/2025 9 p.m. PDT",1283,1230,521,-762
SCL,"3/14/2025 10 p.m. PDT",1234,1192,506,-728
SCL,"3/14/2025 11 p.m. PDT",1169,1128,522,-647
SCL,"3/15/2025 12 a.m. PDT",1104,1065,464,-640
SCL,"3/15/2025 1 a.m. PDT",1045,1005,335,-710
SCL,"3/15/2025 2 a.m. PDT",1006,973,315,-691
SCL,"3/15/2025 3 a.m. PDT",980,953,347,-633
SCL,"3/15/2025 4 a.m. PDT",975,949,320,-655
SCL,"3/15/2025 5 a.m. PDT",989,964,330,-659
SCL,"3/15/2025 6 a.m. PDT",1033,1000,374,-659
SCL,"3/15/2025 7 a.m. PDT",1110,1062,478,-632
SCL,"3/15/2025 8 a.m. PDT",1169,1127,361,-808
SCL,"3/15/2025 9 a.m. PDT",1234,1193,278,-956
SCL,"3/15/2025 10 a.m. PDT",1260,1241,267,-993
SCL,"3/15/2025 11 a.m. PDT",1281,1257,250,-1031
SCL,"3/15/2025 12 p.m. PDT",1270,1257,138,-1132
SCL,"3/15/2025 1 p.m. PDT",1265,1249,144,-1121
SCL,"3/15/2025 2 p.m. PDT",1267,1222,141,-1126
SCL,"3/15/2025 3 p.m. PDT",1252,1203,136,-1116
SCL,"3/15/2025 4 p.m. PDT",1218,1190,136,-1082
SCL,"3/15/2025 5 p.m. PDT",1229,1204,424,-805
SCL,"3/15/2025 6 p.m. PDT",1257,1219,419,-838
SCL,"3/15/2025 7 p.m. PDT",1298,1236,535,-763
SCL,"3/15/2025 8 p.m. PDT",1324,1266,586,-738
SCL,"3/15/2025 9 p.m. PDT",1308,1259,593,-715
SCL,"3/15/2025 10 p.m. PDT",1262,1216,435,-827
SCL,"3/15/2025 11 p.m. PDT",1213,1160,444,-769
SCL,"3/16/2025 12 a.m. PDT",1141,1089,445,-696
SCL,"3/16/2025 1 a.m. PDT",1081,1060,256,-825
SCL,"3/16/2025 2 a.m. PDT",1027,1019,252,-775
SCL,"3/16/2025 3 a.m. PDT",1010,1000,251,-759
SCL,"3/16/2025 4 a.m. PDT",1013,992,263,-750
SCL,"3/16/2025 5 a.m. PDT",1007,993,250,-757
SCL,"3/16/2025 6 a.m. PDT",1050,1013,251,-799
SCL,"3/16/2025 7 a.m. PDT",1080,1059,442,-638
SCL,"3/16/2025 8 a.m. PDT",1163,1110,449,-714
SCL,"3/16/2025 9 a.m. PDT",1215,1157,461,-754
SCL,"3/16/2025 10 a.m. PDT",1277,1197,367,-910
SCL,"3/16/2025 11 a.m. PDT",1302,1215,191,-1111
SCL,"3/16/2025 12 p.m. PDT",1299,1206,170,-1129
SCL,"3/16/2025 1 p.m. PDT",1288,1198,164,-1124
SCL,"3/16/2025 2 p.m. PDT",1237,1177,151,-1086
SCL,"3/16/2025 3 p.m. PDT",1177,1162,149,-1028
SCL,"3/16/2025 4 p.m. PDT",1151,1154,155,-996
SCL,"3/16/2025 5 p.m. PDT",1160,1170,309,-851
SCL,"3/16/2025 6 p.m. PDT",1214,1202,511,-703
SCL,"3/16/2025 7 p.m. PDT",1255,1230,691,-564
SCL,"3/16/2025 8 p.m. PDT",1306,1268,635,-671
SCL,"3/16/2025 9 p.m. PDT",1315,1279,647,-668
SCL,"3/16/2025 10 p.m. PDT",1268,1236,648,-620
SCL,"3/16/2025 11 p.m. PDT",1186,1162,463,-723
SCL,"3/17/2025 12 a.m. PDT",1103,1078,238,-865
SCL,"3/17/2025 1 a.m. PDT",1049,1007,230,-819
SCL,"3/17/2025 2 a.m. PDT",1024,975,218,-806
SCL,"3/17/2025 3 a.m. PDT",1012,966,224,-788
SCL,"3/17/2025 4 a.m. PDT",1018,980,187,-831
SCL,"3/17/2025 5 a.m. PDT",1060,1030,221,-839
SCL,"3/17/2025 6 a.m. PDT",1159,1131,524,-635
SCL,"3/17/2025 7 a.m. PDT",1302,1277,524,-778
SCL,"3/17/2025 8 a.m. PDT",1425,1393,625,-800
SCL,"3/17/2025 9 a.m. PDT",1461,1415,624,-837
SCL,"3/17/2025 10 a.m. PDT",1448,1401,594,-854
SCL,"3/17/2025 11 a.m. PDT",1438,1373,567,-871
SCL,"3/17/2025 12 p.m. PDT",1374,1345,210,-1164
SCL,"3/17/2025 1 p.m. PDT",1304,1323,220,-1084
SCL,"3/17/2025 2 p.m. PDT",1269,1305,214,-1055
SCL,"3/17/2025 3 p.m. PDT",1248,1275,207,-1041
SCL,"3/17/2025 4 p.m. PDT",1296,1251,214,-1082
SCL,"3/17/2025 5 p.m. PDT",1351,1257,304,-1047
SCL,"3/17/2025 6 p.m. PDT",1409,1288,450,-959
SCL,"3/17/2025 7 p.m. PDT",1379,1310,653,-726
SCL,"3/17/2025 8 p.m. PDT",1388,1334,664,-724
SCL,"3/17/2025 9 p.m. PDT",1373,1326,605,-768
SCL,"3/17/2025 10 p.m. PDT",1305,1271,539,-766
SCL,"3/17/2025 11 p.m. PDT",1188,1184,437,-751
SCL,"3/18/2025 12 a.m. PDT",1110,1096,221,-889
SCL,"3/18/2025 1 a.m. PDT",1045,1055,286,-759
SCL,"3/18/2025 2 a.m. PDT",1019,1026,284,-735
SCL,"3/18/2025 3 a.m. PDT",1013,1014,231,-782
SCL,"3/18/2025 4 a.m. PDT",1033,1021,233,-800
SCL,"3/18/2025 5 a.m. PDT",1074,1060,243,-831
SCL,"3/18/2025 6 a.m. PDT",1187,1156,564,-623
SCL,"3/18/2025 7 a.m. PDT",1352,1305,717,-635
SCL,"3/18/2025 8 a.m. PDT",1481,1417,823,-658
SCL,"3/18/2025 9 a.m. PDT",1510,1431,716,-794
SCL,"3/18/2025 10 a.m. PDT",1447,1400,517,-930
SCL,"3/18/2025 11 a.m. PDT",1424,1360,542,-882
SCL,"3/18/2025 12 p.m. PDT",1359,1320,391,-968
SCL,"3/18/2025 1 p.m. PDT",1325,1286,226,-1099
SCL,"3/18/2025 2 p.m. PDT",1285,1254,223,-1062
SCL,"3/18/2025 3 p.m. PDT",1250,1225,224,-1026
SCL,"3/18/2025 4 p.m. PDT",1227,1217,223,-1004
SCL,"3/18/2025 5 p.m. PDT",1238,1225,402,-836
SCL,"3/18/2025 6 p.m. PDT",1287,1250,470,-817
SCL,"3/18/2025 7 p.m. PDT",1299,1269,653,-646
SCL,"3/18/2025 8 p.m. PDT",1324,1298,638,-686
SCL,"3/18/2025 9 p.m. PDT",1322,1293,621,-701
SCL,"3/18/2025 10 p.m. PDT",1267,1246,581,-686
SCL,"3/18/2025 11 p.m. PDT",1176,1159,457,-719
SCL,"3/19/2025 12 a.m. PDT",1090,1077,400,-690
SCL,"3/19/2025 1 a.m. PDT",1025,990,277,-748
SCL,"3/19/2025 2 a.m. PDT",991,956,257,-734
SCL,"3/19/2025 3 a.m. PDT",977,941,245,-732
SCL,"3/19/2025 4 a.m. PDT",968,946,205,-763
SCL,"3/19/2025 5 a.m. PDT",975,985,222,-753
SCL,"3/19/2025 6 a.m. PDT",1071,1079,426,-645
SCL,"3/19/2025 7 a.m. PDT",1224,1218,643,-581
SCL,"3/19/2025 8 a.m. PDT",1336,1322,745,-591
SCL,"3/19/2025 9 a.m. PDT",1340,1334,563,-777
SCL,"3/19/2025 10 a.m. PDT",1302,1311,641,-661
SCL,"3/19/2025 11 a.m. PDT",1287,1272,581,-706
SCL,"3/19/2025 12 p.m. PDT",1277,1233,470,-807
SCL,"3/19/2025 1 p.m. PDT",1242,1207,445,-797
SCL,"3/19/2025 2 p.m. PDT",1226,1185,441,-785
SCL,"3/19/2025 3 p.m. PDT",1222,1170,398,-824
SCL,"3/19/2025 4 p.m. PDT",1203,1166,408,-795
SCL,"3/19/2025 5 p.m. PDT",1213,1180,457,-756
SCL,"3/19/2025 6 p.m. PDT",1243,1210,533,-710
SCL,"3/19/2025 7 p.m. PDT",1252,1223,786,-466
SCL,"3/19/2025 8 p.m. PDT",1262,1250,925,-337
SCL,"3/19/2025 9 p.m. PDT",1232,1237,772,-460
SCL,"3/19/2025 10 p.m. PDT",1186,1191,565,-621
SCL,"3/19/2025 11 p.m. PDT",1101,1114,442,-659
SCL,"3/20/2025 12 a.m. PDT",1023,1025,386,-637
SCL,"3/20/2025 1 a.m. PDT",972,964,271,-701
SCL,"3/20/2025 2 a.m. PDT",935,941,221,-714
SCL,"3/20/2025 3 a.m. PDT",915,925,199,-716
SCL,"3/20/2025 4 a.m. PDT",922,927,201,-721
SCL,"3/20/2025 5 a.m. PDT",967,959,223,-744
SCL,"3/20/2025 6 a.m. PDT",1077,1047,452,-625
SCL,"3/20/2025 7 a.m. PDT",1233,1186,593,-640
SCL,"3/20/2025 8 a.m. PDT",1345,1290,760,-585
SCL,"3/20/2025 9 a.m. PDT",1377,1311,551,-826
SCL,"3/20/2025 10 a.m. PDT",1356,1299,484,-872
SCL,"3/20/2025 11 a.m. PDT",1311,1285,392,-919
SCL,"3/20/2025 12 p.m. PDT",1317,1269,388,-929
SCL,"3/20/2025 1 p.m. PDT",1325,1253,220,-1105
SCL,"3/20/2025 2 p.m. PDT",1294,1242,248,-1046
SCL,"3/20/2025 3 p.m. PDT",1271,1227,256,-1015
SCL,"3/20/2025 4 p.m. PDT",1259,1221,256,-1003
SCL,"3/20/2025 5 p.m. PDT",1264,1228,437,-827
SCL,"3/20/2025 6 p.m. PDT",1289,1240,497,-792
SCL,"3/20/2025 7 p.m. PDT",1299,1245,592,-707
SCL,"3/20/2025 8 p.m. PDT",1310,1261,541,-769
SCL,"3/20/2025 9 p.m. PDT",1292,1248,487,-805
SCL,"3/20/2025 10 p.m. PDT",1229,1195,456,-773
SCL,"3/20/2025 11 p.m. PDT",1149,1114,391,-758
SCL,"3/21/2025 12 a.m. PDT",1052,1033,359,-693
SCL,"3/21/2025 1 a.m. PDT",995,998,511,-484
SCL,"3/21/2025 2 a.m. PDT",950,966,492,-458
SCL,"3/21/2025 3 a.m. PDT",934,947,492,-442
SCL,"3/21/2025 4 a.m. PDT",935,945,503,-432
SCL,"3/21/2025 5 a.m. PDT",967,973,525,-442
SCL,"3/21/2025 6 a.m. PDT",1063,1050,541,-522
SCL,"3/21/2025 7 a.m. PDT",1201,1172,694,-507
SCL,"3/21/2025 8 a.m. PDT",1311,1273,739,-572
SCL,"3/21/2025 9 a.m. PDT",1334,1302,453,-881
SCL,"3/21/2025 10 a.m. PDT",1353,1301,392,-961
SCL,"3/21/2025 11 a.m. PDT",1315,1290,384,-931
SCL,"3/21/2025 12 p.m. PDT",1318,1276,220,-1098
SCL,"3/21/2025 1 p.m. PDT",1293,1261,237,-1056
SCL,"3/21/2025 2 p.m. PDT",1274,1239,285,-989
SCL,"3/21/2025 3 p.m. PDT",1240,1211,252,-988
SCL,"3/21/2025 4 p.m. PDT",1198,1211,241,-957
SCL,"3/21/2025 5 p.m. PDT",1246,1216,240,-1006
SCL,"3/21/2025 6 p.m. PDT",1306,1233,451,-855
SCL,"3/21/2025 7 p.m. PDT",1272,1226,810,-462
SCL,"3/21/2025 8 p.m. PDT",1277,1235,739,-538
SCL,"3/21/2025 9 p.m. PDT",1270,1223,712,-558
SCL,"3/21/2025 10 p.m. PDT",1224,1184,590,-634
SCL,"3/21/2025 11 p.m. PDT",1161,1120,604,-557
SCL,"3/22/2025 12 a.m. PDT",1092,1053,590,-502
SCL,"3/22/2025 1 a.m. PDT",1042,1003,536,-506
SCL,"3/22/2025 2 a.m. PDT",1008,970,500,-508
SCL,"3/22/2025 3 a.m. PDT",991,950,489,-502
SCL,"3/22/2025 4 a.m. PDT",991,942,490,-501
SCL,"3/22/2025 5 a.m. PDT",1006,950,489,-517
SCL,"3/22/2025 6 a.m. PDT",1043,982,525,-518
SCL,"3/22/2025 7 a.m. PDT",1101,1041,388,-713
SCL,"3/22/2025 8 a.m. PDT",1170,1105,405,-765
SCL,"3/22/2025 9 a.m. PDT",1227,1163,405,-822
SCL,"3/22/2025 10 a.m. PDT",1252,1189,396,-856
SCL,"3/22/2025 11 a.m. PDT",1244,1180,419,-825
SCL,"3/22/2025 12 p.m. PDT",1195,1156,232,-963
SCL,"3/22/2025 1 p.m. PDT",1165,1132,272,-893
SCL,"3/22/2025 2 p.m. PDT",1123,1093,265,-858
SCL,"3/22/2025 3 p.m. PDT",1098,1069,255,-843
SCL,"3/22/2025 4 p.m. PDT",1106,1060,272,-834
SCL,"3/22/2025 5 p.m. PDT",1122,1074,298,-824
SCL,"3/22/2025 6 p.m. PDT",1151,1094,403,-748
SCL,"3/22/2025 7 p.m. PDT",1162,1106,655,-507
SCL,"3/22/2025 8 p.m. PDT",1184,1140,667,-517
SCL,"3/22/2025 9 p.m. PDT",1183,1145,604,-579
SCL,"3/22/2025 10 p.m. PDT",1165,1118,563,-602
SCL,"3/22/2025 11 p.m. PDT",1116,1068,707,-409
SCL,"3/23/2025 12 a.m. PDT",1051,1012,663,-388
SCL,"3/23/2025 1 a.m. PDT",1000,961,524,-476
SCL,"3/23/2025 2 a.m. PDT",965,926,507,-458
SCL,"3/23/2025 3 a.m. PDT",942,904,503,-439
SCL,"3/23/2025 4 a.m. PDT",940,894,496,-444
SCL,"3/23/2025 5 a.m. PDT",946,898,481,-465
SCL,"3/23/2025 6 a.m. PDT",967,920,494,-473
SCL,"3/23/2025 7 a.m. PDT",1018,965,604,-414
SCL,"3/23/2025 8 a.m. PDT",1077,1008,622,-455
SCL,"3/23/2025 9 a.m. PDT",1119,1052,395,-724
SCL,"3/23/2025 10 a.m. PDT",1159,1087,238,-921
SCL,"3/23/2025 11 a.m. PDT",1197,1105,263,-934
SCL,"3/23/2025 12 p.m. PDT",1217,1101,270,-947
SCL,"3/23/2025 1 p.m. PDT",1216,1097,270,-946
SCL,"3/23/2025 2 p.m. PDT",1204,1082,267,-937
SCL,"3/23/2025 3 p.m. PDT",1206,1068,266,-940
SCL,"3/23/2025 4 p.m. PDT",1210,1069,263,-947
SCL,"3/23/2025 5 p.m. PDT",1219,1087,285,-934
SCL,"3/23/2025 6 p.m. PDT",1233,1110,447,-786
SCL,"3/23/2025 7 p.m. PDT",1249,1130,694,-555
SCL,"3/23/2025 8 p.m. PDT",1259,1151,728,-531
SCL,"3/23/2025 9 p.m. PDT",1236,1154,672,-564
SCL,"3/23/2025 10 p.m. PDT",1184,1111,571,-613
SCL,"3/23/2025 11 p.m. PDT",1112,1036,415,-697
SCL,"3/24/2025 12 a.m. PDT",958,948,439,-519
SCL,"3/24/2025 1 a.m. PDT",964,922,410,-554
SCL,"3/24/2025 2 a.m. PDT",921,876,336,-585
SCL,"3/24/2025 3 a.m. PDT",909,859,325,-584
SCL,"3/24/2025 4 a.m. PDT",912,860,279,-633
SCL,"3/24/2025 5 a.m. PDT",957,885,312,-645
SCL,"3/24/2025 6 a.m. PDT",1044,957,401,-643
SCL,"3/24/2025 7 a.m. PDT",1158,1068,528,-630
SCL,"3/24/2025 8 a.m. PDT",1261,1156,530,-731
SCL,"3/24/2025 9 a.m. PDT",1281,1183,382,-899
SCL,"3/24/2025 10 a.m. PDT",1282,1186,217,-1065
SCL,"3/24/2025 11 a.m. PDT",1284,1177,223,-1061
SCL,"3/24/2025 12 p.m. PDT",1266,1170,381,-885
SCL,"3/24/2025 1 p.m. PDT",1261,1164,166,-1095
SCL,"3/24/2025 2 p.m. PDT",1224,1152,150,-1074
SCL,"3/24/2025 3 p.m. PDT",1205,1129,147,-1058
SCL,"3/24/2025 4 p.m. PDT",1202,1114,248,-954
SCL,"3/24/2025 5 p.m. PDT",1223,1121,438,-785
SCL,"3/24/2025 6 p.m. PDT",1232,1143,466,-766
SCL,"3/24/2025 7 p.m. PDT",1214,1145,804,-410
SCL,"3/24/2025 8 p.m. PDT",1224,1155,819,-405
SCL,"3/24/2025 9 p.m. PDT",1195,1138,820,-375
SCL,"3/24/2025 10 p.m. PDT",1143,1084,690,-453
SCL,"3/24/2025 11 p.m. PDT",1059,1004,448,-611
SCL,"3/25/2025 12 a.m. PDT",976,922,454,-522
SCL,"3/25/2025 1 a.m. PDT",908,874,345,-563
SCL,"3/25/2025 2 a.m. PDT",865,836,347,-518
SCL,"3/25/2025 3 a.m. PDT",857,816,346,-511
SCL,"3/25/2025 4 a.m. PDT",841,812,348,-493
SCL,"3/25/2025 5 a.m. PDT",853,834,372,-481
SCL,"3/25/2025 6 a.m. PDT",941,904,438,-503
SCL,"3/25/2025 7 a.m. PDT",1047,1030,589,-458
SCL,"3/25/2025 8 a.m. PDT",1145,1123,586,-559
SCL,"3/25/2025 9 a.m. PDT",1154,1132,285,-869
SCL,"3/25/2025 10 a.m. PDT",1168,1112,288,-880
SCL,"3/25/2025 11 a.m. PDT",1137,1089,288,-849
SCL,"3/25/2025 12 p.m. PDT",1109,1068,286,-823
SCL,"3/25/2025 1 p.m. PDT",1105,1060,183,-922
SCL,"3/25/2025 2 p.m. PDT",1085,1056,181,-904
SCL,"3/25/2025 3 p.m. PDT",1081,1049,186,-895
SCL,"3/25/2025 4 p.m. PDT",1073,1046,188,-885
SCL,"3/25/2025 5 p.m. PDT",1081,1054,289,-792
SCL,"3/25/2025 6 p.m. PDT",1090,1072,569,-521
SCL,"3/25/2025 7 p.m. PDT",1085,1068,790,-295
SCL,"3/25/2025 8 p.m. PDT",1109,1078,800,-309
SCL,"3/25/2025 9 p.m. PDT",1110,1067,659,-451
SCL,"3/25/2025 10 p.m. PDT",1052,1022,599,-453
SCL,"3/25/2025 11 p.m. PDT",997,949,437,-560
SCL,"3/26/2025 12 a.m. PDT",922,873,400,-522
SCL,"3/26/2025 1 a.m. PDT",862,824,350,-512
SCL,"3/26/2025 2 a.m. PDT",814,789,345,-469
SCL,"3/26/2025 3 a.m. PDT",755,770,342,-413
SCL,"3/26/2025 4 a.m. PDT",755,769,340,-415
SCL,"3/26/2025 5 a.m. PDT",648,795,351,-297
SCL,"3/26/2025 6 a.m. PDT",856,870,347,-509
SCL,"3/26/2025 7 a.m. PDT",979,1000,384,-595
SCL,"3/26/2025 8 a.m. PDT",1077,1098,554,-523
SCL,"3/26/2025 9 a.m. PDT",1115,1110,581,-534
SCL,"3/26/2025 10 a.m. PDT",1112,1087,343,-769
SCL,"3/26/2025 11 a.m. PDT",1103,1058,362,-741
SCL,"3/26/2025 12 p.m. PDT",1092,1033,391,-701
SCL,"3/26/2025 1 p.m. PDT",1061,1024,378,-683
SCL,"3/26/2025 2 p.m. PDT",1072,1021,302,-770
SCL,"3/26/2025 3 p.m. PDT",1045,1018,288,-757
SCL,"3/26/2025 4 p.m. PDT",1027,1021,311,-716
SCL,"3/26/2025 5 p.m. PDT",1043,1023,309,-734
SCL,"3/26/2025 6 p.m. PDT",1045,1028,463,-582
SCL,"3/26/2025 7 p.m. PDT",1067,1018,840,-227
SCL,"3/26/2025 8 p.m. PDT",1101,1038,862,-239
SCL,"3/26/2025 9 p.m. PDT",1055,1037,830,-225
SCL,"3/26/2025 10 p.m. PDT",1009,1002,834,-175
SCL,"3/26/2025 11 p.m. PDT",940,938,692,-248
SCL,"3/27/2025 12 a.m. PDT",869,871,671,-198
SCL,"3/27/2025 1 a.m. PDT",815,822,456,-359
SCL,"3/27/2025 2 a.m. PDT",778,790,434,-344
SCL,"3/27/2025 3 a.m. PDT",759,773,434,-325
SCL,"3/27/2025 4 a.m. PDT",760,776,438,-322
SCL,"3/27/2025 5 a.m. PDT",786,809,454,-332
SCL,"3/27/2025 6 a.m. PDT",862,892,508,-354
SCL,"3/27/2025 7 a.m. PDT",999,1027,630,-369
SCL,"3/27/2025 8 a.m. PDT",1107,1133,759,-348
SCL,"3/27/2025 9 a.m. PDT",1119,1158,579,-540
SCL,"3/27/2025 10 a.m. PDT",1121,1138,567,-554
SCL,"3/27/2025 11 a.m. PDT",1096,1113,562,-534
SCL,"3/27/2025 12 p.m. PDT",1062,1089,525,-537
SCL,"3/27/2025 1 p.m. PDT",1076,1078,256,-820
SCL,"3/27/2025 2 p.m. PDT",1087,1067,264,-823
SCL,"3/27/2025 3 p.m. PDT",1077,1051,266,-811
SCL,"3/27/2025 4 p.m. PDT",1078,1040,319,-759
SCL,"3/27/2025 5 p.m. PDT",1102,1047,430,-672
SCL,"3/27/2025 6 p.m. PDT",1107,1063,468,-639
SCL,"3/27/2025 7 p.m. PDT",1102,1073,883,-219
SCL,"3/27/2025 8 p.m. PDT",1114,1096,910,-204
SCL,"3/27/2025 9 p.m. PDT",1110,1093,917,-193
SCL,"3/27/2025 10 p.m. PDT",1060,1054,826,-234
SCL,"3/27/2025 11 p.m. PDT",836,989,617,-219
SCL,"3/28/2025 12 a.m. PDT",915,919,505,-410
SCL,"3/28/2025 1 a.m. PDT",859,868,497,-362
SCL,"3/28/2025 2 a.m. PDT",821,829,494,-327
SCL,"3/28/2025 3 a.m. PDT",799,811,495,-304
SCL,"3/28/2025 4 a.m. PDT",804,812,495,-309
SCL,"3/28/2025 5 a.m. PDT",832,845,499,-333
SCL,"3/28/2025 6 a.m. PDT",913,927,646,-267
SCL,"3/28/2025 7 a.m. PDT",1041,1057,699,-342
SCL,"3/28/2025 8 a.m. PDT",1151,1164,717,-434
SCL,"3/28/2025 9 a.m. PDT",1193,1198,727,-466
SCL,"3/28/2025 10 a.m. PDT",1203,1199,475,-728
SCL,"3/28/2025 11 a.m. PDT",1221,1195,454,-767
SCL,"3/28/2025 12 p.m. PDT",1217,1195,423,-794
SCL,"3/28/2025 1 p.m. PDT",1223,1186,427,-796
SCL,"3/28/2025 2 p.m. PDT",1211,1174,413,-798
SCL,"3/28/2025 3 p.m. PDT",1190,1148,415,-775
SCL,"3/28/2025 4 p.m. PDT",1185,1137,423,-762
SCL,"3/28/2025 5 p.m. PDT",1158,1134,458,-700
SCL,"3/28/2025 6 p.m. PDT",1161,1147,515,-646
SCL,"3/28/2025 7 p.m. PDT",1156,1130,891,-265
SCL,"3/28/2025 8 p.m. PDT",1163,1133,878,-285
SCL,"3/28/2025 9 p.m. PDT",1177,1130,883,-294
SCL,"3/28/2025 10 p.m. PDT",1137,1097,855,-282
SCL,"3/28/2025 11 p.m. PDT",1091,1036,842,-249
SCL,"3/29/2025 12 a.m. PDT",1036,975,807,-229
SCL,"3/29/2025 1 a.m. PDT",977,939,644,-333
SCL,"3/29/2025 2 a.m. PDT",938,900,644,-294
SCL,"3/29/2025 3 a.m. PDT",925,877,643,-282
SCL,"3/29/2025 4 a.m. PDT",908,870,641,-267
SCL,"3/29/2025 5 a.m. PDT",880,881,723,-157
SCL,"3/29/2025 6 a.m. PDT",908,919,768,-140
SCL,"3/29/2025 7 a.m. PDT",969,978,604,-365
SCL,"3/29/2025 8 a.m. PDT",1036,1042,643,-393
SCL,"3/29/2025 9 a.m. PDT",1113,1098,592,-521
SCL,"3/29/2025 10 a.m. PDT",1146,1126,551,-595
SCL,"3/29/2025 11 a.m. PDT",1169,1119,395,-774
SCL,"3/29/2025 12 p.m. PDT",1144,1102,259,-885
SCL,"3/29/2025 1 p.m. PDT",1139,1080,228,-911
SCL,"3/29/2025 2 p.m. PDT",1108,1051,276,-832
SCL,"3/29/2025 3 p.m. PDT",1070,1030,287,-783
SCL,"3/29/2025 4 p.m. PDT",1055,1018,273,-782
SCL,"3/29/2025 5 p.m. PDT",1046,1034,425,-621
SCL,"3/29/2025 6 p.m. PDT",1052,1047,482,-570
SCL,"3/29/2025 7 p.m. PDT",1074,1061,842,-232
SCL,"3/29/2025 8 p.m. PDT",1104,1080,926,-178
SCL,"3/29/2025 9 p.m. PDT",1122,1099,883,-239
SCL,"3/29/2025 10 p.m. PDT",1105,1075,814,-291
SCL,"3/29/2025 11 p.m. PDT",1060,1032,818,-242
SCL,"3/30/2025 12 a.m. PDT",1011,987,830,-181
SCL,"3/30/2025 1 a.m. PDT",972,919,808,-164
SCL,"3/30/2025 2 a.m. PDT",930,889,808,-122
SCL,"3/30/2025 3 a.m. PDT",918,870,798,-120
SCL,"3/30/2025 4 a.m. PDT",903,865,796,-107
SCL,"3/30/2025 5 a.m. PDT",912,876,810,-102
SCL,"3/30/2025 6 a.m. PDT",948,908,808,-140
SCL,"3/30/2025 7 a.m. PDT",1002,957,801,-201
SCL,"3/30/2025 8 a.m. PDT",1057,1004,859,-198
SCL,"3/30/2025 9 a.m. PDT",1110,1042,694,-416
SCL,"3/30/2025 10 a.m. PDT",1116,1068,604,-512
SCL,"3/30/2025 11 a.m. PDT",1132,1075,408,-724
SCL,"3/30/2025 12 p.m. PDT",1101,1057,397,-704
SCL,"3/30/2025 1 p.m. PDT",1060,1045,391,-669
SCL,"3/30/2025 2 p.m. PDT",1019,1037,403,-616
SCL,"3/30/2025 3 p.m. PDT",1018,1027,438,-580
SCL,"3/30/2025 4 p.m. PDT",1027,1028,428,-599
SCL,"3/30/2025 5 p.m. PDT",1054,1046,482,-572
SCL,"3/30/2025 6 p.m. PDT",1089,1074,661,-428
SCL,"3/30/2025 7 p.m. PDT",1125,1091,936,-189
SCL,"3/30/2025 8 p.m. PDT",1152,1108,935,-217
SCL,"3/30/2025 9 p.m. PDT",1150,1123,895,-255
SCL,"3/30/2025 10 p.m. PDT",1099,1089,859,-240
SCL,"3/30/2025 11 p.m. PDT",1033,1026,812,-221
SCL,"3/31/2025 12 a.m. PDT",961,945,803,-158
SCL,"3/31/2025 1 a.m. PDT",908,861,649,-259
SCL,"3/31/2025 2 a.m. PDT",865,826,648,-217
SCL,"3/31/2025 3 a.m. PDT",809,815,652,-157
SCL,"3/31/2025 4 a.m. PDT",816,825,648,-168
SCL,"3/31/2025 5 a.m. PDT",856,869,655,-201
SCL,"3/31/2025 6 a.m. PDT",953,964,652,-301
SCL,"3/31/2025 7 a.m. PDT",1089,1103,669,-420
SCL,"3/31/2025 8 a.m. PDT",1189,1212,677,-512
SCL,"3/31/2025 9 a.m. PDT",1222,1245,669,-553
SCL,"3/31/2025 10 a.m. PDT",1186,1241,657,-529
SCL,"3/31/2025 11 a.m. PDT",1179,1234,510,-669
SCL,"3/31/2025 12 p.m. PDT",1169,1228,490,-679
SCL,"3/31/2025 1 p.m. PDT",1153,1222,465,-688
SCL,"3/31/2025 2 p.m. PDT",1148,1216,467,-681
SCL,"3/31/2025 3 p.m. PDT",1103,1189,424,-679
SCL,"3/31/2025 4 p.m. PDT",1111,1178,377,-734
SCL,"3/31/2025 5 p.m. PDT",1143,1189,449,-694
SCL,"3/31/2025 6 p.m. PDT",1197,1202,646,-551
SCL,"3/31/2025 7 p.m. PDT",1194,1201,844,-350
SCL,"3/31/2025 8 p.m. PDT",1227,1211,961,-266
SCL,"3/31/2025 9 p.m. PDT",1250,1208,950,-300
SCL,"3/31/2025 10 p.m. PDT",1154,1159,977,-177
SCL,"3/31/2025 11 p.m. PDT",1096,1085,876,-220