"BA Code","Timestamp (Hour Ending)","Demand (MWh)","Demand Forecast (MWh)","Net Generation (MWh)","Total Interchange (MWh)"
SCL,"8/1/2024 12 a.m. PDT",897,909,456,-441
SCL,"8/1/2024 1 a.m. PDT",835,842,273,-562
SCL,"8/1/2024 2 a.m. PDT",783,798,225,-558
SCL,"8/1/2024 3 a.m. PDT",761,772,147,-614
SCL,"8/1/2024 4 a.m. PDT",748,764,140,-608
SCL,"8/1/2024 5 a.m. PDT",760,777,142,-618
SCL,"8/1/2024 6 a.m. PDT",794,823,161,-633
SCL,"8/1/2024 7 a.m. PDT",873,900,192,-681
SCL,"8/1/2024 8 a.m. PDT",966,982,362,-604
SCL,"8/1/2024 9 a.m. PDT",1030,1030,363,-667
SCL,"8/1/2024 10 a.m. PDT",1078,1062,429,-649
SCL,"8/1/2024 11 a.m. PDT",1106,1089,457,-649
SCL,"8/1/2024 12 p.m. PDT",1138,1117,478,-660
SCL,"8/1/2024 1 p.m. PDT",1160,1139,453,-707
SCL,"8/1/2024 2 p.m. PDT",1182,1160,438,-744
SCL,"8/1/2024 3 p.m. PDT",1198,1180,472,-726
SCL,"8/1/2024 4 p.m. PDT",1219,1196,450,-769
SCL,"8/1/2024 5 p.m. PDT",1239,1222,484,-755
SCL,"8/1/2024 6 p.m. PDT",1242,1233,778,-464
SCL,"8/1/2024 7 p.m. PDT",1214,1199,840,-374
SCL,"8/1/2024 8 p.m. PDT",1195,1156,769,-426
SCL,"8/1/2024 9 p.m. PDT",1165,1125,647,-518
SCL,"8/1/2024 10 p.m. PDT",1150,1108,528,-622
SCL,"8/1/2024 11 p.m. PDT",1074,1037,411,-663
SCL,"8/2/2024 12 a.m. PDT",992,960,328,-664
SCL,"8/2/2024 1 a.m. PDT",915,927,315,-600
SCL,"8/2/2024 2 a.m. PDT",860,876,240,-620
SCL,"8/2/2024 3 a.m. PDT",825,843,243,-582
SCL,"8/2/2024 4 a.m. PDT",810,826,183,-627
SCL,"8/2/2024 5 a.m. PDT",816,830,159,-657
SCL,"8/2/2024 6 a.m. PDT",862,868,238,-624
SCL,"8/2/2024 7 a.m. PDT",935,939,160,-775
SCL,"8/2/2024 8 a.m. PDT",1019,1016,198,-821
SCL,"8/2/2024 9 a.m. PDT",1093,1063,505,-588
SCL,"8/2/2024 10 a.m. PDT",1148,1097,426,-722
SCL,"8/2/2024 11 a.m. PDT",1188,1122,455,-733
SCL,"8/2/2024 12 p.m. PDT",1236,1148,514,-722
SCL,"8/2/2024 1 p.m. PDT",1264,1165,576,-688
SCL,"8/2/2024 2 p.m. PDT",1299,1188,598,-701
SCL,"8/2/2024 3 p.m. PDT",1308,1204,724,-584
SCL,"8/2/2024 4 p.m. PDT",1315,1228,627,-688
SCL,"8/2/2024 5 p.m. PDT",1345,1250,605,-740
SCL,"8/2/2024 6 p.m. PDT",1341,1258,614,-727
SCL,"8/2/2024 7 p.m. PDT",1303,1213,740,-563
SCL,"8/2/2024 8 p.m. PDT",1259,1173,717,-542
SCL,"8/2/2024 9 p.m. PDT",1210,1133,442,-768
SCL,"8/2/2024 10 p.m. PDT",1181,1107,261,-920
SCL,"8/2/2024 11 p.m. PDT",1105,1045,293,-812
SCL,"8/3/2024 12 a.m. PDT",1030,977,240,-790
SCL,"8/3/2024 1 a.m. PDT",927,925,310,-617
SCL,"8/3/2024 2 a.m. PDT",861,876,236,-625
SCL,"8/3/2024 3 a.m. PDT",820,838,207,-613
SCL,"8/3/2024 4 a.m. PDT",798,812,137,-661
SCL,"8/3/2024 5 a.m. PDT",783,801,174,-609
SCL,"8/3/2024 6 a.m. PDT",785,804,162,-623
SCL,"8/3/2024 7 a.m. PDT",795,818,143,-652
SCL,"8/3/2024 8 a.m. PDT",875,870,201,-674
SCL,"8/3/2024 9 a.m. PDT",932,932,284,-648
SCL,"8/3/2024 10 a.m. PDT",988,977,411,-577
SCL,"8/3/2024 11 a.m. PDT",1017,1016,406,-611
SCL,"8/3/2024 12 p.m. PDT",1041,1047,414,-627
SCL,"8/3/2024 1 p.m. PDT",1057,1064,414,-643
SCL,"8/3/2024 2 p.m. PDT",1092,1072,414,-678
SCL,"8/3/2024 3 p.m. PDT",1102,1083,430,-672
SCL,"8/3/2024 4 p.m. PDT",1114,1102,429,-685
SCL,"8/3/2024 5 p.m. PDT",1131,1122,431,-700
SCL,"8/3/2024 6 p.m. PDT",1151,1140,581,-570
SCL,"8/3/2024 7 p.m. PDT",1132,1137,582,-550
SCL,"8/3/2024 8 p.m. PDT",1157,1120,557,-600
SCL,"8/3/2024 9 p.m. PDT",1102,1099,436,-666
SCL,"8/3/2024 10 p.m. PDT",1109,1082,416,-693
SCL,"8/3/2024 11 p.m. PDT",1057,1033,359,-698
SCL,"8/4/2024 12 a.m. PDT",995,971,289,-706
SCL,"8/4/2024 1 a.m. PDT",926,894,238,-688
SCL,"8/4/2024 2 a.m. PDT",864,848,212,-652
SCL,"8/4/2024 3 a.m. PDT",835,816,186,-649
SCL,"8/4/2024 4 a.m. PDT",817,793,149,-668
SCL,"8/4/2024 5 a.m. PDT",794,780,144,-650
SCL,"8/4/2024 6 a.m. PDT",808,778,146,-662
SCL,"8/4/2024 7 a.m. PDT",795,789,238,-557
SCL,"8/4/2024 8 a.m. PDT",860,834,280,-580
SCL,"8/4/2024 9 a.m. PDT",914,883,283,-631
SCL,"8/4/2024 10 a.m. PDT",969,932,297,-672
SCL,"8/4/2024 11 a.m. PDT",1002,973,318,-684
SCL,"8/4/2024 12 p.m. PDT",1037,1005,248,-789
SCL,"8/4/2024 1 p.m. PDT",1061,1029,278,-783
SCL,"8/4/2024 2 p.m. PDT",1088,1055,442,-646
SCL,"8/4/2024 3 p.m. PDT",1116,1075,466,-650
SCL,"8/4/2024 4 p.m. PDT",1148,1094,440,-708
SCL,"8/4/2024 5 p.m. PDT",1194,1126,446,-748
SCL,"8/4/2024 6 p.m. PDT",1234,1152,637,-597
SCL,"8/4/2024 7 p.m. PDT",1259,1163,701,-558
SCL,"8/4/2024 8 p.m. PDT",1253,1150,778,-475
SCL,"8/4/2024 9 p.m. PDT",1216,1140,690,-526
SCL,"8/4/2024 10 p.m. PDT",1186,1121,509,-677
SCL,"8/4/2024 11 p.m. PDT",1091,1052,444,-647
SCL,"8/5/2024 12 a.m. PDT",901,969,249,-652
SCL,"8/5/2024 1 a.m. PDT",921,901,256,-665
SCL,"8/5/2024 2 a.m. PDT",872,844,190,-682
SCL,"8/5/2024 3 a.m. PDT",846,818,160,-686
SCL,"8/5/2024 4 a.m. PDT",832,808,137,-695
SCL,"8/5/2024 5 a.m. PDT",836,814,125,-711
SCL,"8/5/2024 6 a.m. PDT",856,854,198,-658
SCL,"8/5/2024 7 a.m. PDT",937,916,194,-743
SCL,"8/5/2024 8 a.m. PDT",1003,981,218,-785
SCL,"8/5/2024 9 a.m. PDT",1055,1020,388,-667
SCL,"8/5/2024 10 a.m. PDT",1094,1045,389,-705
SCL,"8/5/2024 11 a.m. PDT",1105,1062,385,-720
SCL,"8/5/2024 12 p.m. PDT",1125,1084,394,-731
SCL,"8/5/2024 1 p.m. PDT",1134,1101,391,-743
SCL,"8/5/2024 2 p.m. PDT",1164,1120,392,-772
SCL,"8/5/2024 3 p.m. PDT",1177,1134,419,-758
SCL,"8/5/2024 4 p.m. PDT",1199,1149,437,-762
SCL,"8/5/2024 5 p.m. PDT",1234,1172,585,-649
SCL,"8/5/2024 6 p.m. PDT",1251,1192,531,-720
SCL,"8/5/2024 7 p.m. PDT",1228,1164,713,-515
SCL,"8/5/2024 8 p.m. PDT",1189,1126,687,-502
SCL,"8/5/2024 9 p.m. PDT",1149,1097,640,-509
SCL,"8/5/2024 10 p.m. PDT",1117,1072,434,-683
SCL,"8/5/2024 11 p.m. PDT",1033,992,301,-732
SCL,"8/6/2024 12 a.m. PDT",945,914,276,-669
SCL,"8/6/2024 1 a.m. PDT",874,846,270,-604
SCL,"8/6/2024 2 a.m. PDT",829,797,118,-711
SCL,"8/6/2024 3 a.m. PDT",802,771,119,-683
SCL,"8/6/2024 4 a.m. PDT",781,763,121,-660
SCL,"8/6/2024 5 a.m. PDT",793,776,117,-676
SCL,"8/6/2024 6 a.m. PDT",842,825,153,-689
SCL,"8/6/2024 7 a.m. PDT",920,900,212,-708
SCL,"8/6/2024 8 a.m. PDT",994,978,214,-780
SCL,"8/6/2024 9 a.m. PDT",1036,1025,184,-852
SCL,"8/6/2024 10 a.m. PDT",1044,1047,185,-859
SCL,"8/6/2024 11 a.m. PDT",1066,1063,221,-845
SCL,"8/6/2024 12 p.m. PDT",1074,1081,223,-851
SCL,"8/6/2024 1 p.m. PDT",1068,1098,222,-846
SCL,"8/6/2024 2 p.m. PDT",1083,1110,231,-852
SCL,"8/6/2024 3 p.m. PDT",1071,1119,310,-761
SCL,"8/6/2024 4 p.m. PDT",1077,1130,462,-615
SCL,"8/6/2024 5 p.m. PDT",1096,1151,448,-648
SCL,"8/6/2024 6 p.m. PDT",1118,1163,544,-574
SCL,"8/6/2024 7 p.m. PDT",1082,1147,722,-360
SCL,"8/6/2024 8 p.m. PDT",1079,1110,756,-323
SCL,"8/6/2024 9 p.m. PDT",1063,1088,635,-428
SCL,"8/6/2024 10 p.m. PDT",1040,1074,529,-511
SCL,"8/6/2024 11 p.m. PDT",987,997,493,-494
SCL,"8/7/2024 12 a.m. PDT",904,916,321,-583
SCL,"8/7/2024 1 a.m. PDT",852,820,334,-518
SCL,"8/7/2024 2 a.m. PDT",816,779,210,-606
SCL,"8/7/2024 3 a.m. PDT",791,757,163,-628
SCL,"8/7/2024 4 a.m. PDT",766,749,170,-596
SCL,"8/7/2024 5 a.m. PDT",739,763,177,-562
SCL,"8/7/2024 6 a.m. PDT",777,813,216,-561
SCL,"8/7/2024 7 a.m. PDT",850,888,359,-491
SCL,"8/7/2024 8 a.m. PDT",917,966,311,-606
SCL,"8/7/2024 9 a.m. PDT",968,1011,259,-709
SCL,"8/7/2024 10 a.m. PDT",985,1033,250,-735
SCL,"8/7/2024 11 a.m. PDT",992,1051,239,-753
SCL,"8/7/2024 12 p.m. PDT",1017,1070,362,-655
SCL,"8/7/2024 1 p.m. PDT",1025,1084,356,-669
SCL,"8/7/2024 2 p.m. PDT",1048,1101,359,-689
SCL,"8/7/2024 3 p.m. PDT",1071,1118,467,-604
SCL,"8/7/2024 4 p.m. PDT",1094,1137,473,-621
SCL,"8/7/2024 5 p.m. PDT",1132,1159,474,-658
SCL,"8/7/2024 6 p.m. PDT",1143,1172,659,-484
SCL,"8/7/2024 7 p.m. PDT",1139,1141,939,-200
SCL,"8/7/2024 8 p.m. PDT",1109,1111,861,-248
SCL,"8/7/2024 9 p.m. PDT",1080,1082,717,-363
SCL,"8/7/2024 10 p.m. PDT",1055,1064,485,-570
SCL,"8/7/2024 11 p.m. PDT",978,989,384,-594
SCL,"8/8/2024 12 a.m. PDT",897,907,264,-633
SCL,"8/8/2024 1 a.m. PDT",826,850,147,-679
SCL,"8/8/2024 2 a.m. PDT",779,802,136,-643
SCL,"8/8/2024 3 a.m. PDT",749,777,127,-622
SCL,"8/8/2024 4 a.m. PDT",740,766,88,-652
SCL,"8/8/2024 5 a.m. PDT",750,777,87,-663
SCL,"8/8/2024 6 a.m. PDT",793,823,165,-628
SCL,"8/8/2024 7 a.m. PDT",861,898,372,-489
SCL,"8/8/2024 8 a.m. PDT",923,976,360,-563
SCL,"8/8/2024 9 a.m. PDT",980,1022,262,-718
SCL,"8/8/2024 10 a.m. PDT",1019,1052,256,-763
SCL,"8/8/2024 11 a.m. PDT",1046,1078,275,-771
SCL,"8/8/2024 12 p.m. PDT",1087,1105,363,-724
SCL,"8/8/2024 1 p.m. PDT",1116,1127,502,-614
SCL,"8/8/2024 2 p.m. PDT",1151,1148,403,-748
SCL,"8/8/2024 3 p.m. PDT",1168,1167,555,-613
SCL,"8/8/2024 4 p.m. PDT",1198,1186,456,-742
SCL,"8/8/2024 5 p.m. PDT",1227,1219,484,-743
SCL,"8/8/2024 6 p.m. PDT",1242,1217,704,-538
SCL,"8/8/2024 7 p.m. PDT",1213,1189,946,-267
SCL,"8/8/2024 8 p.m. PDT",1178,1151,894,-284
SCL,"8/8/2024 9 p.m. PDT",1152,1121,809,-343
SCL,"8/8/2024 10 p.m. PDT",1126,1100,615,-511
SCL,"8/8/2024 11 p.m. PDT",1049,1024,266,-783
SCL,"8/9/2024 12 a.m. PDT",962,950,256,-706
SCL,"8/9/2024 1 a.m. PDT",891,904,235,-656
SCL,"8/9/2024 2 a.m. PDT",843,856,156,-687
SCL,"8/9/2024 3 a.m. PDT",803,825,116,-687
SCL,"8/9/2024 4 a.m. PDT",793,810,125,-668
SCL,"8/9/2024 5 a.m. PDT",790,816,118,-672
SCL,"8/9/2024 6 a.m. PDT",833,859,172,-661
SCL,"8/9/2024 7 a.m. PDT",892,929,338,-554
SCL,"8/9/2024 8 a.m. PDT",956,1003,310,-646
SCL,"8/9/2024 9 a.m. PDT",1031,1048,238,-793
SCL,"8/9/2024 10 a.m. PDT",1106,1080,227,-879
SCL,"8/9/2024 11 a.m. PDT",1143,1101,199,-944
SCL,"8/9/2024 12 p.m. PDT",1146,1126,441,-705
SCL,"8/9/2024 1 p.m. PDT",1183,1143,299,-884
SCL,"8/9/2024 2 p.m. PDT",1207,1167,326,-881
SCL,"8/9/2024 3 p.m. PDT",1227,1180,310,-917
SCL,"8/9/2024 4 p.m. PDT",1240,1203,391,-849
SCL,"8/9/2024 5 p.m. PDT",1279,1223,452,-827
SCL,"8/9/2024 6 p.m. PDT",1292,1228,642,-650
SCL,"8/9/2024 7 p.m. PDT",1241,1186,701,-540
SCL,"8/9/2024 8 p.m. PDT",1209,1147,608,-601
SCL,"8/9/2024 9 p.m. PDT",1177,1112,562,-615
SCL,"8/9/2024 10 p.m. PDT",1152,1086,530,-622
SCL,"8/9/2024 11 p.m. PDT",1072,1022,353,-719
SCL,"8/10/2024 12 a.m. PDT",997,958,312,-685
SCL,"8/10/2024 1 a.m. PDT",924,901,254,-670
SCL,"8/10/2024 2 a.m. PDT",874,852,187,-687
SCL,"8/10/2024 3 a.m. PDT",840,817,186,-654
SCL,"8/10/2024 4 a.m. PDT",822,796,151,-671
SCL,"8/10/2024 5 a.m. PDT",807,789,148,-659
SCL,"8/10/2024 6 a.m. PDT",818,798,261,-557
SCL,"8/10/2024 7 a.m. PDT",825,815,317,-508
SCL,"8/10/2024 8 a.m. PDT",860,867,343,-517
SCL,"8/10/2024 9 a.m. PDT",915,930,296,-619
SCL,"8/10/2024 10 a.m. PDT",964,974,327,-637
SCL,"8/10/2024 11 a.m. PDT",984,1009,321,-663
SCL,"8/10/2024 12 p.m. PDT",994,1038,415,-579
SCL,"8/10/2024 1 p.m. PDT",1017,1056,474,-543
SCL,"8/10/2024 2 p.m. PDT",1025,1066,487,-538
SCL,"8/10/2024 3 p.m. PDT",1022,1077,524,-498
SCL,"8/10/2024 4 p.m. PDT",1042,1097,539,-503
SCL,"8/10/2024 5 p.m. PDT",1097,1123,719,-378
SCL,"8/10/2024 6 p.m. PDT",1122,1139,795,-327
SCL,"8/10/2024 7 p.m. PDT",1142,1136,760,-382
SCL,"8/10/2024 8 p.m. PDT",1117,1121,822,-295
SCL,"8/10/2024 9 p.m. PDT",1096,1104,690,-406
SCL,"8/10/2024 10 p.m. PDT",1073,1076,681,-392
SCL,"8/10/2024 11 p.m. PDT",1012,1017,397,-615
SCL,"8/11/2024 12 a.m. PDT",952,953,372,-580
SCL,"8/11/2024 1 a.m. PDT",873,856,284,-589
SCL,"8/11/2024 2 a.m. PDT",839,809,190,-649
SCL,"8/11/2024 3 a.m. PDT",807,779,193,-614
SCL,"8/11/2024 4 a.m. PDT",793,759,167,-626
SCL,"8/11/2024 5 a.m. PDT",795,748,167,-628
SCL,"8/11/2024 6 a.m. PDT",796,750,167,-629
SCL,"8/11/2024 7 a.m. PDT",797,759,275,-522
SCL,"8/11/2024 8 a.m. PDT",829,797,261,-568
SCL,"8/11/2024 9 a.m. PDT",870,842,295,-575
SCL,"8/11/2024 10 a.m. PDT",918,883,298,-620
SCL,"8/11/2024 11 a.m. PDT",946,915,277,-669
SCL,"8/11/2024 12 p.m. PDT",960,938,291,-669
SCL,"8/11/2024 1 p.m. PDT",977,954,439,-538
SCL,"8/11/2024 2 p.m. PDT",982,964,498,-484
SCL,"8/11/2024 3 p.m. PDT",980,975,519,-461
SCL,"8/11/2024 4 p.m. PDT",995,992,502,-493
SCL,"8/11/2024 5 p.m. PDT",1016,1021,550,-466
SCL,"8/11/2024 6 p.m. PDT",1035,1048,658,-377
SCL,"8/11/2024 7 p.m. PDT",1047,1052,678,-369
SCL,"8/11/2024 8 p.m. PDT",1037,1044,703,-334
SCL,"8/11/2024 9 p.m. PDT",1027,1037,664,-363
SCL,"8/11/2024 10 p.m. PDT",1019,1022,459,-560
SCL,"8/11/2024 11 p.m. PDT",969,954,338,-631
SCL,"8/12/2024 12 a.m. PDT",888,881,235,-653
SCL,"8/12/2024 1 a.m. PDT",835,807,120,-715
SCL,"8/12/2024 2 a.m. PDT",804,763,114,-690
SCL,"8/12/2024 3 a.m. PDT",782,745,116,-666
SCL,"8/12/2024 4 a.m. PDT",765,740,118,-647
SCL,"8/12/2024 5 a.m. PDT",774,754,118,-656
SCL,"8/12/2024 6 a.m. PDT",830,803,120,-710
SCL,"8/12/2024 7 a.m. PDT",887,871,259,-628
SCL,"8/12/2024 8 a.m. PDT",926,937,266,-660
SCL,"8/12/2024 9 a.m. PDT",961,972,217,-744
SCL,"8/12/2024 10 a.m. PDT",1012,991,219,-793
SCL,"8/12/2024 11 a.m. PDT",1051,998,383,-668
SCL,"8/12/2024 12 p.m. PDT",1068,1009,409,-659
SCL,"8/12/2024 1 p.m. PDT",1072,1020,437,-635
SCL,"8/12/2024 2 p.m. PDT",1079,1028,392,-687
SCL,"8/12/2024 3 p.m. PDT",1097,1027,399,-698
SCL,"8/12/2024 4 p.m. PDT",1103,1038,419,-684
SCL,"8/12/2024 5 p.m. PDT",1110,1054,408,-702
SCL,"8/12/2024 6 p.m. PDT",1123,1077,562,-561
SCL,"8/12/2024 7 p.m. PDT",1101,1055,489,-612
SCL,"8/12/2024 8 p.m. PDT",1073,1029,466,-607
SCL,"8/12/2024 9 p.m. PDT",1074,1015,435,-639
SCL,"8/12/2024 10 p.m. PDT",1030,993,439,-591
SCL,"8/12/2024 11 p.m. PDT",969,916,238,-731
SCL,"8/13/2024 12 a.m. PDT",894,843,212,-682
SCL,"8/13/2024 1 a.m. PDT",834,805,268,-566
SCL,"8/13/2024 2 a.m. PDT",796,764,235,-561
SCL,"8/13/2024 3 a.m. PDT",779,743,217,-562
SCL,"8/13/2024 4 a.m. PDT",775,736,193,-582
SCL,"8/13/2024 5 a.m. PDT",787,748,129,-658
SCL,"8/13/2024 6 a.m. PDT",822,798,261,-561
SCL,"8/13/2024 7 a.m. PDT",903,871,396,-507
SCL,"8/13/2024 8 a.m. PDT",963,943,389,-574
SCL,"8/13/2024 9 a.m. PDT",1024,981,385,-639
SCL,"8/13/2024 10 a.m. PDT",1046,998,383,-663
SCL,"8/13/2024 11 a.m. PDT",1047,1006,383,-664
SCL,"8/13/2024 12 p.m. PDT",1067,1016,383,-684
SCL,"8/13/2024 1 p.m. PDT",1089,1027,400,-689
SCL,"8/13/2024 2 p.m. PDT",1086,1032,407,-679
SCL,"8/13/2024 3 p.m. PDT",1089,1036,409,-680
SCL,"8/13/2024 4 p.m. PDT",1098,1043,407,-691
SCL,"8/13/2024 5 p.m. PDT",1083,1058,495,-588
SCL,"8/13/2024 6 p.m. PDT",1081,1069,636,-445
SCL,"8/13/2024 7 p.m. PDT",1066,1044,597,-469
SCL,"8/13/2024 8 p.m. PDT",1069,1022,598,-471
SCL,"8/13/2024 9 p.m. PDT",1065,1014,584,-481
SCL,"8/13/2024 10 p.m. PDT",1033,997,551,-482
SCL,"8/13/2024 11 p.m. PDT",978,926,383,-595
SCL,"8/14/2024 12 a.m. PDT",901,854,328,-573
SCL,"8/14/2024 1 a.m. PDT",843,809,284,-559
SCL,"8/14/2024 2 a.m. PDT",809,772,257,-552
SCL,"8/14/2024 3 a.m. PDT",783,750,241,-542
SCL,"8/14/2024 4 a.m. PDT",742,742,143,-599
SCL,"8/14/2024 5 a.m. PDT",740,755,137,-603
SCL,"8/14/2024 6 a.m. PDT",791,805,160,-631
SCL,"8/14/2024 7 a.m. PDT",854,877,279,-575
SCL,"8/14/2024 8 a.m. PDT",927,948,248,-679
SCL,"8/14/2024 9 a.m. PDT",972,989,241,-731
SCL,"8/14/2024 10 a.m. PDT",997,1006,354,-643
SCL,"8/14/2024 11 a.m. PDT",1028,1019,392,-636
SCL,"8/14/2024 12 p.m. PDT",1043,1032,438,-605
SCL,"8/14/2024 1 p.m. PDT",1060,1045,434,-626
SCL,"8/14/2024 2 p.m. PDT",1075,1057,459,-616
SCL,"8/14/2024 3 p.m. PDT",1084,1067,506,-578
SCL,"8/14/2024 4 p.m. PDT",1112,1077,555,-557
SCL,"8/14/2024 5 p.m. PDT",1135,1096,615,-520
SCL,"8/14/2024 6 p.m. PDT",1149,1109,789,-360
SCL,"8/14/2024 7 p.m. PDT",1131,1077,892,-239
SCL,"8/14/2024 8 p.m. PDT",1092,1048,823,-269
SCL,"8/14/2024 9 p.m. PDT",1071,1037,563,-508
SCL,"8/14/2024 10 p.m. PDT",1038,1019,588,-450
SCL,"8/14/2024 11 p.m. PDT",968,946,393,-575
SCL,"8/15/2024 12 a.m. PDT",883,867,342,-541
SCL,"8/15/2024 1 a.m. PDT",820,837,265,-555
SCL,"8/15/2024 2 a.m. PDT",771,790,119,-652
SCL,"8/15/2024 3 a.m. PDT",745,764,118,-627
SCL,"8/15/2024 4 a.m. PDT",733,753,113,-620
SCL,"8/15/2024 5 a.m. PDT",743,762,119,-624
SCL,"8/15/2024 6 a.m. PDT",789,808,120,-669
SCL,"8/15/2024 7 a.m. PDT",852,879,211,-641
SCL,"8/15/2024 8 a.m. PDT",931,948,218,-713
SCL,"8/15/2024 9 a.m. PDT",980,990,357,-623
SCL,"8/15/2024 10 a.m. PDT",1005,1011,349,-656
SCL,"8/15/2024 11 a.m. PDT",1021,1026,352,-669
SCL,"8/15/2024 12 p.m. PDT",1054,1042,393,-661
SCL,"8/15/2024 1 p.m. PDT",1062,1053,387,-675
SCL,"8/15/2024 2 p.m. PDT",1077,1063,410,-667
SCL,"8/15/2024 3 p.m. PDT",1084,1073,517,-567
SCL,"8/15/2024 4 p.m. PDT",1092,1083,557,-535
SCL,"8/15/2024 5 p.m. PDT",1128,1102,623,-505
SCL,"8/15/2024 6 p.m. PDT",1135,1110,682,-453
SCL,"8/15/2024 7 p.m. PDT",1103,1075,668,-435
SCL,"8/15/2024 8 p.m. PDT",1062,1049,779,-283
SCL,"8/15/2024 9 p.m. PDT",1044,1040,489,-555
SCL,"8/15/2024 10 p.m. PDT",1017,1020,519,-498
SCL,"8/15/2024 11 p.m. PDT",948,949,298,-650
SCL,"8/16/2024 12 a.m. PDT",870,875,255,-615
SCL,"8/16/2024 1 a.m. PDT",816,829,155,-661
SCL,"8/16/2024 2 a.m. PDT",768,780,143,-625
SCL,"8/16/2024 3 a.m. PDT",740,756,143,-597
SCL,"8/16/2024 4 a.m. PDT",734,747,150,-584
SCL,"8/16/2024 5 a.m. PDT",742,760,186,-556
SCL,"8/16/2024 6 a.m. PDT",789,809,266,-523
SCL,"8/16/2024 7 a.m. PDT",846,880,190,-656
SCL,"8/16/2024 8 a.m. PDT",921,949,197,-724
SCL,"8/16/2024 9 a.m. PDT",954,991,296,-658
SCL,"8/16/2024 10 a.m. PDT",988,1008,296,-692
SCL,"8/16/2024 11 a.m. PDT",1005,1015,393,-612
SCL,"8/16/2024 12 p.m. PDT",1007,1022,402,-605
SCL,"8/16/2024 1 p.m. PDT",1018,1028,395,-623
SCL,"8/16/2024 2 p.m. PDT",1025,1034,400,-625
SCL,"8/16/2024 3 p.m. PDT",1024,1040,449,-575
SCL,"8/16/2024 4 p.m. PDT",1028,1047,449,-579
SCL,"8/16/2024 5 p.m. PDT",1051,1061,455,-596
SCL,"8/16/2024 6 p.m. PDT",1068,1066,568,-500
SCL,"8/16/2024 7 p.m. PDT",1038,1033,662,-376
SCL,"8/16/2024 8 p.m. PDT",1002,1007,703,-299
SCL,"8/16/2024 9 p.m. PDT",987,995,586,-401
SCL,"8/16/2024 10 p.m. PDT",958,966,510,-448
SCL,"8/16/2024 11 p.m. PDT",902,907,341,-561
SCL,"8/17/2024 12 a.m. PDT",843,849,318,-525
SCL,"8/17/2024 1 a.m. PDT",793,805,155,-638
SCL,"8/17/2024 2 a.m. PDT",746,761,149,-597
SCL,"8/17/2024 3 a.m. PDT",730,734,137,-593
SCL,"8/17/2024 4 a.m. PDT",710,722,133,-577
SCL,"8/17/2024 5 a.m. PDT",706,726,129,-577
SCL,"8/17/2024 6 a.m. PDT",720,747,138,-582
SCL,"8/17/2024 7 a.m. PDT",737,773,244,-493
SCL,"8/17/2024 8 a.m. PDT",786,826,240,-546
SCL,"8/17/2024 9 a.m. PDT",857,885,246,-611
SCL,"8/17/2024 10 a.m. PDT",904,926,279,-625
SCL,"8/17/2024 11 a.m. PDT",934,952,274,-660
SCL,"8/17/2024 12 p.m. PDT",955,968,246,-709
SCL,"8/17/2024 1 p.m. PDT",973,976,241,-732
SCL,"8/17/2024 2 p.m. PDT",969,983,241,-728
SCL,"8/17/2024 3 p.m. PDT",973,986,373,-600
SCL,"8/17/2024 4 p.m. PDT",979,999,412,-567
SCL,"8/17/2024 5 p.m. PDT",1004,1026,458,-546
SCL,"8/17/2024 6 p.m. PDT",1019,1030,687,-332
SCL,"8/17/2024 7 p.m. PDT",1008,1033,747,-261
SCL,"8/17/2024 8 p.m. PDT",1004,1018,800,-204
SCL,"8/17/2024 9 p.m. PDT",998,1012,670,-328
SCL,"8/17/2024 10 p.m. PDT",968,987,488,-480
SCL,"8/17/2024 11 p.m. PDT",909,936,411,-498
SCL,"8/18/2024 12 a.m. PDT",850,878,334,-516
SCL,"8/18/2024 1 a.m. PDT",809,804,232,-577
SCL,"8/18/2024 2 a.m. PDT",770,774,206,-564
SCL,"8/18/2024 3 a.m. PDT",738,746,183,-555
SCL,"8/18/2024 4 a.m. PDT",722,729,166,-556
SCL,"8/18/2024 5 a.m. PDT",732,725,168,-564
SCL,"8/18/2024 6 a.m. PDT",735,735,181,-554
SCL,"8/18/2024 7 a.m. PDT",752,751,212,-540
SCL,"8/18/2024 8 a.m. PDT",800,789,256,-544
SCL,"8/18/2024 9 a.m. PDT",872,836,258,-614
SCL,"8/18/2024 10 a.m. PDT",937,874,406,-531
SCL,"8/18/2024 11 a.m. PDT",991,903,454,-537
SCL,"8/18/2024 12 p.m. PDT",997,923,396,-601
SCL,"8/18/2024 1 p.m. PDT",1026,939,408,-618
SCL,"8/18/2024 2 p.m. PDT",1032,951,407,-625
SCL,"8/18/2024 3 p.m. PDT",1042,964,452,-590
SCL,"8/18/2024 4 p.m. PDT",1060,977,545,-515
SCL,"8/18/2024 5 p.m. PDT",1068,1004,747,-321
SCL,"8/18/2024 6 p.m. PDT",1024,1021,786,-238
SCL,"8/18/2024 7 p.m. PDT",1047,1025,797,-250
SCL,"8/18/2024 8 p.m. PDT",1045,1016,784,-261
SCL,"8/18/2024 9 p.m. PDT",1033,1015,679,-354
SCL,"8/18/2024 10 p.m. PDT",983,992,492,-491
SCL,"8/18/2024 11 p.m. PDT",946,934,197,-749
SCL,"8/19/2024 12 a.m. PDT",868,862,125,-743
SCL,"8/19/2024 1 a.m. PDT",795,807,152,-643
SCL,"8/19/2024 2 a.m. PDT",762,773,152,-610
SCL,"8/19/2024 3 a.m. PDT",739,752,91,-648
SCL,"8/19/2024 4 a.m. PDT",724,748,86,-638
SCL,"8/19/2024 5 a.m. PDT",737,765,121,-616
SCL,"8/19/2024 6 a.m. PDT",788,816,221,-567
SCL,"8/19/2024 7 a.m. PDT",865,887,381,-484
SCL,"8/19/2024 8 a.m. PDT",930,956,380,-550
SCL,"8/19/2024 9 a.m. PDT",1014,999,388,-626
SCL,"8/19/2024 10 a.m. PDT",1056,1020,384,-672
SCL,"8/19/2024 11 a.m. PDT",1087,1033,410,-677
SCL,"8/19/2024 12 p.m. PDT",1105,1049,390,-715
SCL,"8/19/2024 1 p.m. PDT",1117,1062,425,-692
SCL,"8/19/2024 2 p.m. PDT",1129,1072,410,-719
SCL,"8/19/2024 3 p.m. PDT",1145,1075,445,-700
SCL,"8/19/2024 4 p.m. PDT",1146,1085,440,-706
SCL,"8/19/2024 5 p.m. PDT",1141,1102,495,-646
SCL,"8/19/2024 6 p.m. PDT",1157,1105,753,-404
SCL,"8/19/2024 7 p.m. PDT",1122,1083,742,-380
SCL,"8/19/2024 8 p.m. PDT",1074,1054,703,-371
SCL,"8/19/2024 9 p.m. PDT",1063,1042,660,-403
SCL,"8/19/2024 10 p.m. PDT",1029,1012,534,-495
SCL,"8/19/2024 11 p.m. PDT",961,937,246,-715
SCL,"8/20/2024 12 a.m. PDT",888,864,219,-669
SCL,"8/20/2024 1 a.m. PDT",824,798,152,-672
SCL,"8/20/2024 2 a.m. PDT",803,762,123,-680
SCL,"8/20/2024 3 a.m. PDT",782,741,122,-660
SCL,"8/20/2024 4 a.m. PDT",773,735,118,-655
SCL,"8/20/2024 5 a.m. PDT",787,751,86,-701
SCL,"8/20/2024 6 a.m. PDT",841,804,141,-700
SCL,"8/20/2024 7 a.m. PDT",919,882,399,-520
SCL,"8/20/2024 8 a.m. PDT",987,955,410,-577
SCL,"8/20/2024 9 a.m. PDT",1027,999,419,-608
SCL,"8/20/2024 10 a.m. PDT",1049,1016,417,-632
SCL,"8/20/2024 11 a.m. PDT",1069,1028,434,-635
SCL,"8/20/2024 12 p.m. PDT",1087,1040,436,-651
SCL,"8/20/2024 1 p.m. PDT",1088,1055,465,-623
SCL,"8/20/2024 2 p.m. PDT",1097,1063,468,-629
SCL,"8/20/2024 3 p.m. PDT",1073,1066,466,-607
SCL,"8/20/2024 4 p.m. PDT",1085,1068,466,-619
SCL,"8/20/2024 5 p.m. PDT",1098,1081,445,-653
SCL,"8/20/2024 6 p.m. PDT",1085,1080,592,-493
SCL,"8/20/2024 7 p.m. PDT",1075,1057,763,-312
SCL,"8/20/2024 8 p.m. PDT",1057,1035,723,-334
SCL,"8/20/2024 9 p.m. PDT",1053,1028,686,-367
SCL,"8/20/2024 10 p.m. PDT",1029,1001,543,-486
SCL,"8/20/2024 11 p.m. PDT",952,929,277,-675
SCL,"8/21/2024 12 a.m. PDT",884,859,258,-626
SCL,"8/21/2024 1 a.m. PDT",830,798,165,-665
SCL,"8/21/2024 2 a.m. PDT",804,760,134,-670
SCL,"8/21/2024 3 a.m. PDT",778,740,126,-652
SCL,"8/21/2024 4 a.m. PDT",775,733,128,-647
SCL,"8/21/2024 5 a.m. PDT",738,745,93,-645
SCL,"8/21/2024 6 a.m. PDT",783,796,133,-650
SCL,"8/21/2024 7 a.m. PDT",863,868,227,-636
SCL,"8/21/2024 8 a.m. PDT",932,934,231,-701
SCL,"8/21/2024 9 a.m. PDT",976,972,244,-732
SCL,"8/21/2024 10 a.m. PDT",995,987,271,-724
SCL,"8/21/2024 11 a.m. PDT",1008,996,267,-741
SCL,"8/21/2024 12 p.m. PDT",1020,1005,274,-746
SCL,"8/21/2024 1 p.m. PDT",1031,1016,306,-725
SCL,"8/21/2024 2 p.m. PDT",1025,1023,294,-731
SCL,"8/21/2024 3 p.m. PDT",1026,1028,315,-711
SCL,"8/21/2024 4 p.m. PDT",1021,1033,312,-709
SCL,"8/21/2024 5 p.m. PDT",1026,1048,383,-643
SCL,"8/21/2024 6 p.m. PDT",1027,1047,509,-518
SCL,"8/21/2024 7 p.m. PDT",1004,1024,607,-397
SCL,"8/21/2024 8 p.m. PDT",981,1003,668,-313
SCL,"8/21/2024 9 p.m. PDT",984,999,632,-352
SCL,"8/21/2024 10 p.m. PDT",951,967,514,-437
SCL,"8/21/2024 11 p.m. PDT",887,904,302,-585
SCL,"8/22/2024 12 a.m. PDT",823,837,233,-590
SCL,"8/22/2024 1 a.m. PDT",768,781,162,-606
SCL,"8/22/2024 2 a.m. PDT",730,746,127,-603
SCL,"8/22/2024 3 a.m. PDT",715,727,125,-590
SCL,"8/22/2024 4 a.m. PDT",709,720,121,-588
SCL,"8/22/2024 5 a.m. PDT",717,735,121,-596
SCL,"8/22/2024 6 a.m. PDT",763,787,125,-638
SCL,"8/22/2024 7 a.m. PDT",844,864,226,-618
SCL,"8/22/2024 8 a.m. PDT",918,933,234,-684
SCL,"8/22/2024 9 a.m. PDT",965,974,400,-565
SCL,"8/22/2024 10 a.m. PDT",991,993,432,-559
SCL,"8/22/2024 11 a.m. PDT",1002,1005,413,-589
SCL,"8/22/2024 12 p.m. PDT",1024,1017,418,-606
SCL,"8/22/2024 1 p.m. PDT",1031,1030,423,-608
SCL,"8/22/2024 2 p.m. PDT",1032,1038,517,-515
SCL,"8/22/2024 3 p.m. PDT",1023,1043,577,-446
SCL,"8/22/2024 4 p.m. PDT",1026,1044,581,-445
SCL,"8/22/2024 5 p.m. PDT",1035,1061,616,-419
SCL,"8/22/2024 6 p.m. PDT",1031,1057,605,-426
SCL,"8/22/2024 7 p.m. PDT",1009,1032,744,-265
SCL,"8/22/2024 8 p.m. PDT",998,1010,721,-277
SCL,"8/22/2024 9 p.m. PDT",1005,1008,652,-353
SCL,"8/22/2024 10 p.m. PDT",967,976,488,-479
SCL,"8/22/2024 11 p.m. PDT",901,912,259,-642
SCL,"8/23/2024 12 a.m. PDT",838,847,246,-592
SCL,"8/23/2024 1 a.m. PDT",784,793,140,-644
SCL,"8/23/2024 2 a.m. PDT",752,756,117,-635
SCL,"8/23/2024 3 a.m. PDT",722,734,128,-594
SCL,"8/23/2024 4 a.m. PDT",718,727,130,-588
SCL,"8/23/2024 5 a.m. PDT",728,742,128,-600
SCL,"8/23/2024 6 a.m. PDT",768,793,144,-624
SCL,"8/23/2024 7 a.m. PDT",844,866,163,-681
SCL,"8/23/2024 8 a.m. PDT",913,932,258,-655
SCL,"8/23/2024 9 a.m. PDT",977,972,267,-710
SCL,"8/23/2024 10 a.m. PDT",1019,987,266,-753
SCL,"8/23/2024 11 a.m. PDT",1055,991,268,-787
SCL,"8/23/2024 12 p.m. PDT",1081,993,269,-812
SCL,"8/23/2024 1 p.m. PDT",1082,996,267,-815
SCL,"8/23/2024 2 p.m. PDT",1080,996,264,-816
SCL,"8/23/2024 3 p.m. PDT",1072,989,266,-806
SCL,"8/23/2024 4 p.m. PDT",1058,985,431,-627
SCL,"8/23/2024 5 p.m. PDT",1055,992,440,-615
SCL,"8/23/2024 6 p.m. PDT",1053,993,557,-496
SCL,"8/23/2024 7 p.m. PDT",1029,974,574,-455
SCL,"8/23/2024 8 p.m. PDT",992,956,531,-461
SCL,"8/23/2024 9 p.m. PDT",999,956,519,-480
SCL,"8/23/2024 10 p.m. PDT",963,926,486,-477
SCL,"8/23/2024 11 p.m. PDT",911,877,442,-469
SCL,"8/24/2024 12 a.m. PDT",873,826,439,-434
SCL,"8/24/2024 1 a.m. PDT",814,787,139,-675
SCL,"8/24/2024 2 a.m. PDT",787,754,135,-652
SCL,"8/24/2024 3 a.m. PDT",765,732,135,-630
SCL,"8/24/2024 4 a.m. PDT",763,720,103,-660
SCL,"8/24/2024 5 a.m. PDT",762,722,183,-579
SCL,"8/24/2024 6 a.m. PDT",769,743,163,-606
SCL,"8/24/2024 7 a.m. PDT",812,767,267,-545
SCL,"8/24/2024 8 a.m. PDT",861,811,248,-613
SCL,"8/24/2024 9 a.m. PDT",917,863,312,-605
SCL,"8/24/2024 10 a.m. PDT",966,903,266,-700
SCL,"8/24/2024 11 a.m. PDT",993,926,397,-596
SCL,"8/24/2024 12 p.m. PDT",1016,940,361,-655
SCL,"8/24/2024 1 p.m. PDT",1006,941,353,-653
SCL,"8/24/2024 2 p.m. PDT",1018,937,354,-664
SCL,"8/24/2024 3 p.m. PDT",1011,936,355,-656
SCL,"8/24/2024 4 p.m. PDT",984,934,344,-640
SCL,"8/24/2024 5 p.m. PDT",981,947,346,-635
SCL,"8/24/2024 6 p.m. PDT",977,956,348,-629
SCL,"8/24/2024 7 p.m. PDT",982,951,348,-634
SCL,"8/24/2024 8 p.m. PDT",987,945,352,-635
SCL,"8/24/2024 9 p.m. PDT",983,960,342,-641
SCL,"8/24/2024 10 p.m. PDT",958,939,355,-603
SCL,"8/24/2024 11 p.m. PDT",920,894,197,-723
SCL,"8/25/2024 12 a.m. PDT",873,842,178,-695
SCL,"8/25/2024 1 a.m. PDT",828,796,71,-757
SCL,"8/25/2024 2 a.m. PDT",797,758,65,-732
SCL,"8/25/2024 3 a.m. PDT",760,736,69,-691
SCL,"8/25/2024 4 a.m. PDT",757,722,67,-690
SCL,"8/25/2024 5 a.m. PDT",748,718,66,-682
SCL,"8/25/2024 6 a.m. PDT",763,730,68,-695
SCL,"8/25/2024 7 a.m. PDT",769,748,66,-703
SCL,"8/25/2024 8 a.m. PDT",817,778,69,-748
SCL,"8/25/2024 9 a.m. PDT",872,820,164,-708
SCL,"8/25/2024 10 a.m. PDT",910,856,168,-742
SCL,"8/25/2024 11 a.m. PDT",930,879,226,-704
SCL,"8/25/2024 12 p.m. PDT",941,898,225,-716
SCL,"8/25/2024 1 p.m. PDT",947,914,242,-705
SCL,"8/25/2024 2 p.m. PDT",955,923,225,-730
SCL,"8/25/2024 3 p.m. PDT",954,928,253,-701
SCL,"8/25/2024 4 p.m. PDT",968,932,366,-602
SCL,"8/25/2024 5 p.m. PDT",996,950,375,-621
SCL,"8/25/2024 6 p.m. PDT",1019,967,455,-564
SCL,"8/25/2024 7 p.m. PDT",1036,977,489,-547
SCL,"8/25/2024 8 p.m. PDT",1036,971,500,-536
SCL,"8/25/2024 9 p.m. PDT",1034,981,610,-424
SCL,"8/25/2024 10 p.m. PDT",1005,943,557,-448
SCL,"8/25/2024 11 p.m. PDT",940,888,361,-579
SCL,"8/26/2024 12 a.m. PDT",872,826,339,-533
SCL,"8/26/2024 1 a.m. PDT",816,785,76,-740
SCL,"8/26/2024 2 a.m. PDT",769,753,70,-699
SCL,"8/26/2024 3 a.m. PDT",756,735,107,-649
SCL,"8/26/2024 4 a.m. PDT",752,732,106,-646
SCL,"8/26/2024 5 a.m. PDT",760,749,105,-655
SCL,"8/26/2024 6 a.m. PDT",818,801,110,-708
SCL,"8/26/2024 7 a.m. PDT",892,875,185,-707
SCL,"8/26/2024 8 a.m. PDT",970,940,183,-787
SCL,"8/26/2024 9 a.m. PDT",984,979,189,-795
SCL,"8/26/2024 10 a.m. PDT",991,998,469,-522
SCL,"8/26/2024 11 a.m. PDT",1018,1008,219,-799
SCL,"8/26/2024 12 p.m. PDT",1079,1022,213,-866
SCL,"8/26/2024 1 p.m. PDT",1102,1037,360,-742
SCL,"8/26/2024 2 p.m. PDT",1111,1047,360,-751
SCL,"8/26/2024 3 p.m. PDT",1096,1050,383,-713
SCL,"8/26/2024 4 p.m. PDT",1087,1059,396,-691
SCL,"8/26/2024 5 p.m. PDT",1091,1079,398,-693
SCL,"8/26/2024 6 p.m. PDT",1096,1080,507,-589
SCL,"8/26/2024 7 p.m. PDT",1082,1052,561,-521
SCL,"8/26/2024 8 p.m. PDT",1065,1025,448,-617
SCL,"8/26/2024 9 p.m. PDT",1061,1022,514,-547
SCL,"8/26/2024 10 p.m. PDT",1027,978,493,-534
SCL,"8/26/2024 11 p.m. PDT",952,909,217,-735
SCL,"8/27/2024 12 a.m. PDT",887,839,182,-706
SCL,"8/27/2024 1 a.m. PDT",834,794,82,-752
SCL,"8/27/2024 2 a.m. PDT",796,753,71,-725
SCL,"8/27/2024 3 a.m. PDT",756,732,73,-683
SCL,"8/27/2024 4 a.m. PDT",747,726,73,-674
SCL,"8/27/2024 5 a.m. PDT",769,740,78,-691
SCL,"8/27/2024 6 a.m. PDT",817,792,78,-739
SCL,"8/27/2024 7 a.m. PDT",899,869,140,-759
SCL,"8/27/2024 8 a.m. PDT",979,937,206,-773
SCL,"8/27/2024 9 a.m. PDT",1004,977,192,-812
SCL,"8/27/2024 10 a.m. PDT",1017,991,174,-843
SCL,"8/27/2024 11 a.m. PDT",1036,998,74,-962
SCL,"8/27/2024 12 p.m. PDT",1037,1006,72,-965
SCL,"8/27/2024 1 p.m. PDT",1048,1017,74,-974
SCL,"8/27/2024 2 p.m. PDT",1056,1021,93,-963
SCL,"8/27/2024 3 p.m. PDT",1069,1017,166,-903
SCL,"8/27/2024 4 p.m. PDT",1050,1014,184,-866
SCL,"8/27/2024 5 p.m. PDT",1058,1024,300,-758
SCL,"8/27/2024 6 p.m. PDT",1067,1026,613,-454
SCL,"8/27/2024 7 p.m. PDT",1047,1008,570,-477
SCL,"8/27/2024 8 p.m. PDT",1002,991,607,-395
SCL,"8/27/2024 9 p.m. PDT",1033,999,611,-422
SCL,"8/27/2024 10 p.m. PDT",997,965,557,-440
SCL,"8/27/2024 11 p.m. PDT",934,901,317,-617
SCL,"8/28/2024 12 a.m. PDT",861,835,224,-637
SCL,"8/28/2024 1 a.m. PDT",817,778,107,-710
SCL,"8/28/2024 2 a.m. PDT",772,738,81,-691
SCL,"8/28/2024 3 a.m. PDT",758,722,82,-676
SCL,"8/28/2024 4 a.m. PDT",746,719,81,-665
SCL,"8/28/2024 5 a.m. PDT",713,741,95,-618
SCL,"8/28/2024 6 a.m. PDT",763,803,129,-634
SCL,"8/28/2024 7 a.m. PDT",856,894,275,-581
SCL,"8/28/2024 8 a.m. PDT",924,962,240,-684
SCL,"8/28/2024 9 a.m. PDT",954,995,254,-700
SCL,"8/28/2024 10 a.m. PDT",962,991,167,-795
SCL,"8/28/2024 11 a.m. PDT",974,993,153,-821
SCL,"8/28/2024 12 p.m. PDT",985,995,147,-838
SCL,"8/28/2024 1 p.m. PDT",983,1000,242,-741
SCL,"8/28/2024 2 p.m. PDT",992,1003,289,-703
SCL,"8/28/2024 3 p.m. PDT",986,1003,443,-543
SCL,"8/28/2024 4 p.m. PDT",1000,1004,490,-510
SCL,"8/28/2024 5 p.m. PDT",998,1015,505,-493
SCL,"8/28/2024 6 p.m. PDT",1005,1017,601,-404
SCL,"8/28/2024 7 p.m. PDT",1002,992,722,-280
SCL,"8/28/2024 8 p.m. PDT",980,977,666,-314
SCL,"8/28/2024 9 p.m. PDT",982,980,571,-411
SCL,"8/28/2024 10 p.m. PDT",947,947,502,-445
SCL,"8/28/2024 11 p.m. PDT",879,886,256,-623
SCL,"8/29/2024 12 a.m. PDT",804,823,214,-590
SCL,"8/29/2024 1 a.m. PDT",753,774,130,-623
SCL,"8/29/2024 2 a.m. PDT",722,734,124,-598
SCL,"8/29/2024 3 a.m. PDT",693,715,116,-577
SCL,"8/29/2024 4 a.m. PDT",693,711,94,-599
SCL,"8/29/2024 5 a.m. PDT",708,729,85,-623
SCL,"8/29/2024 6 a.m. PDT",761,786,120,-641
SCL,"8/29/2024 7 a.m. PDT",847,877,387,-460
SCL,"8/29/2024 8 a.m. PDT",918,948,405,-513
SCL,"8/29/2024 9 a.m. PDT",963,980,196,-767
SCL,"8/29/2024 10 a.m. PDT",980,993,191,-789
SCL,"8/29/2024 11 a.m. PDT",1004,1003,273,-731
SCL,"8/29/2024 12 p.m. PDT",1017,1013,267,-750
SCL,"8/29/2024 1 p.m. PDT",1033,1025,269,-764
SCL,"8/29/2024 2 p.m. PDT",1038,1034,263,-775
SCL,"8/29/2024 3 p.m. PDT",1050,1040,329,-721
SCL,"8/29/2024 4 p.m. PDT",1055,1044,323,-732
SCL,"8/29/2024 5 p.m. PDT",1075,1063,635,-440
SCL,"8/29/2024 6 p.m. PDT",1085,1058,756,-329
SCL,"8/29/2024 7 p.m. PDT",1067,1029,717,-350
SCL,"8/29/2024 8 p.m. PDT",1029,1005,695,-334
SCL,"8/29/2024 9 p.m. PDT",1038,1003,771,-267
SCL,"8/29/2024 10 p.m. PDT",993,962,769,-224
SCL,"8/29/2024 11 p.m. PDT",921,900,290,-631
SCL,"8/30/2024 12 a.m. PDT",847,839,239,-608
SCL,"8/30/2024 1 a.m. PDT",788,806,133,-655
SCL,"8/30/2024 2 a.m. PDT",753,766,136,-617
SCL,"8/30/2024 3 a.m. PDT",724,742,132,-592
SCL,"8/30/2024 4 a.m. PDT",720,735,133,-587
SCL,"8/30/2024 5 a.m. PDT",723,752,137,-586
SCL,"8/30/2024 6 a.m. PDT",767,805,143,-624
SCL,"8/30/2024 7 a.m. PDT",839,884,292,-547
SCL,"8/30/2024 8 a.m. PDT",917,956,317,-600
SCL,"8/30/2024 9 a.m. PDT",993,1002,307,-686
SCL,"8/30/2024 10 a.m. PDT",1050,1022,305,-745
SCL,"8/30/2024 11 a.m. PDT",1088,1035,300,-788
SCL,"8/30/2024 12 p.m. PDT",1108,1046,298,-810
SCL,"8/30/2024 1 p.m. PDT",1129,1057,303,-826
SCL,"8/30/2024 2 p.m. PDT",1148,1072,334,-814
SCL,"8/30/2024 3 p.m. PDT",1171,1079,381,-790
SCL,"8/30/2024 4 p.m. PDT",1191,1091,380,-811
SCL,"8/30/2024 5 p.m. PDT",1210,1108,464,-746
SCL,"8/30/2024 6 p.m. PDT",1219,1101,599,-620
SCL,"8/30/2024 7 p.m. PDT",1173,1061,596,-577
SCL,"8/30/2024 8 p.m. PDT",1121,1030,578,-543
SCL,"8/30/2024 9 p.m. PDT",1103,1010,584,-519
SCL,"8/30/2024 10 p.m. PDT",1076,970,523,-553
SCL,"8/30/2024 11 p.m. PDT",1000,913,250,-750
SCL,"8/31/2024 12 a.m. PDT",935,859,235,-700
SCL,"8/31/2024 1 a.m. PDT",892,840,141,-751
SCL,"8/31/2024 2 a.m. PDT",837,803,140,-697
SCL,"8/31/2024 3 a.m. PDT",817,772,143,-674
SCL,"8/31/2024 4 a.m. PDT",793,752,140,-653
SCL,"8/31/2024 5 a.m. PDT",790,744,144,-646
SCL,"8/31/2024 6 a.m. PDT",794,751,149,-645
SCL,"8/31/2024 7 a.m. PDT",822,769,244,-578
SCL,"8/31/2024 8 a.m. PDT",867,811,243,-624
SCL,"8/31/2024 9 a.m. PDT",932,872,238,-694
SCL,"8/31/2024 10 a.m. PDT",991,921,242,-749
SCL,"8/31/2024 11 a.m. PDT",1031,958,242,-789
SCL,"8/31/2024 12 p.m. PDT",1060,981,240,-820
SCL,"8/31/2024 1 p.m. PDT",1064,996,244,-820
SCL,"8/31/2024 2 p.m. PDT",1078,1009,239,-839
SCL,"8/31/2024 3 p.m. PDT",1095,1022,258,-837
SCL,"8/31/2024 4 p.m. PDT",1109,1037,282,-827
SCL,"8/31/2024 5 p.m. PDT",1124,1055,318,-806
SCL,"8/31/2024 6 p.m. PDT",1146,1065,661,-485
SCL,"8/31/2024 7 p.m. PDT",1143,1057,641,-502
SCL,"8/31/2024 8 p.m. PDT",1110,1044,605,-505
SCL,"8/31/2024 9 p.m. PDT",1102,1038,615,-487
SCL,"8/31/2024 10 p.m. PDT",1054,1001,532,-522
SCL,"8/31/2024 11 p.m. PDT",992,951,299,-693