"BA Code","Timestamp (Hour Ending)","Demand (MWh)","Demand Forecast (MWh)","Net Generation (MWh)","Total Interchange (MWh)"
SCL,"6/1/2024 12 a.m. PDT",877,843,871,-6
SCL,"6/1/2024 1 a.m. PDT",817,782,518,-299
SCL,"6/1/2024 2 a.m. PDT",788,741,504,-284
SCL,"6/1/2024 3 a.m. PDT",758,717,472,-286
SCL,"6/1/2024 4 a.m. PDT",749,706,471,-278
SCL,"6/1/2024 5 a.m. PDT",748,711,469,-279
SCL,"6/1/2024 6 a.m. PDT",766,728,471,-295
SCL,"6/1/2024 7 a.m. PDT",809,769,699,-110
SCL,"6/1/2024 8 a.m. PDT",840,823,723,-117
SCL,"6/1/2024 9 a.m. PDT",901,878,638,-263
SCL,"6/1/2024 10 a.m. PDT",937,916,595,-342
SCL,"6/1/2024 11 a.m. PDT",970,935,678,-292
SCL,"6/1/2024 12 p.m. PDT",974,944,541,-433
SCL,"6/1/2024 1 p.m. PDT",943,942,545,-398
SCL,"6/1/2024 2 p.m. PDT",928,934,534,-394
SCL,"6/1/2024 3 p.m. PDT",910,923,443,-467
SCL,"6/1/2024 4 p.m. PDT",943,919,395,-548
SCL,"6/1/2024 5 p.m. PDT",941,927,419,-522
SCL,"6/1/2024 6 p.m. PDT",954,936,597,-357
SCL,"6/1/2024 7 p.m. PDT",963,939,719,-244
SCL,"6/1/2024 8 p.m. PDT",962,932,1046,84
SCL,"6/1/2024 9 p.m. PDT",964,929,1062,98
SCL,"6/1/2024 10 p.m. PDT",959,929,1022,63
SCL,"6/1/2024 11 p.m. PDT",876,897,760,-116
SCL,"6/2/2024 12 a.m. PDT",847,843,684,-163
SCL,"6/2/2024 1 a.m. PDT",804,770,603,-201
SCL,"6/2/2024 2 a.m. PDT",776,735,599,-177
SCL,"6/2/2024 3 a.m. PDT",751,711,429,-322
SCL,"6/2/2024 4 a.m. PDT",755,700,426,-329
SCL,"6/2/2024 5 a.m. PDT",741,698,428,-313
SCL,"6/2/2024 6 a.m. PDT",755,705,448,-307
SCL,"6/2/2024 7 a.m. PDT",760,737,462,-298
SCL,"6/2/2024 8 a.m. PDT",828,786,532,-296
SCL,"6/2/2024 9 a.m. PDT",891,838,605,-286
SCL,"6/2/2024 10 a.m. PDT",942,882,582,-360
SCL,"6/2/2024 11 a.m. PDT",981,906,434,-547
SCL,"6/2/2024 12 p.m. PDT",1011,917,467,-544
SCL,"6/2/2024 1 p.m. PDT",1033,920,504,-529
SCL,"6/2/2024 2 p.m. PDT",1002,922,399,-603
SCL,"6/2/2024 3 p.m. PDT",977,920,579,-398
SCL,"6/2/2024 4 p.m. PDT",952,918,574,-378
SCL,"6/2/2024 5 p.m. PDT",971,931,591,-380
SCL,"6/2/2024 6 p.m. PDT",995,955,831,-164
SCL,"6/2/2024 7 p.m. PDT",1009,964,1039,30
SCL,"6/2/2024 8 p.m. PDT",1006,958,1111,105
SCL,"6/2/2024 9 p.m. PDT",994,953,999,5
SCL,"6/2/2024 10 p.m. PDT",993,952,933,-60
SCL,"6/2/2024 11 p.m. PDT",959,908,832,-127
SCL,"6/3/2024 12 a.m. PDT",867,837,618,-249
SCL,"6/3/2024 1 a.m. PDT",823,769,600,-223
SCL,"6/3/2024 2 a.m. PDT",786,739,556,-230
SCL,"6/3/2024 3 a.m. PDT",773,722,540,-233
SCL,"6/3/2024 4 a.m. PDT",768,720,532,-236
SCL,"6/3/2024 5 a.m. PDT",802,735,542,-260
SCL,"6/3/2024 6 a.m. PDT",851,783,548,-303
SCL,"6/3/2024 7 a.m. PDT",949,877,562,-387
SCL,"6/3/2024 8 a.m. PDT",1021,971,538,-483
SCL,"6/3/2024 9 a.m. PDT",1066,1004,595,-471
SCL,"6/3/2024 10 a.m. PDT",1068,1012,601,-467
SCL,"6/3/2024 11 a.m. PDT",1066,1013,497,-569
SCL,"6/3/2024 12 p.m. PDT",1067,1016,493,-574
SCL,"6/3/2024 1 p.m. PDT",1065,1016,511,-554
SCL,"6/3/2024 2 p.m. PDT",1033,1012,514,-519
SCL,"6/3/2024 3 p.m. PDT",1031,1004,583,-448
SCL,"6/3/2024 4 p.m. PDT",1030,1003,464,-566
SCL,"6/3/2024 5 p.m. PDT",1050,1011,475,-575
SCL,"6/3/2024 6 p.m. PDT",1068,1022,873,-195
SCL,"6/3/2024 7 p.m. PDT",1065,1010,877,-188
SCL,"6/3/2024 8 p.m. PDT",1048,996,871,-177
SCL,"6/3/2024 9 p.m. PDT",1049,988,865,-184
SCL,"6/3/2024 10 p.m. PDT",1033,987,869,-164
SCL,"6/3/2024 11 p.m. PDT",970,936,787,-183
SCL,"6/4/2024 12 a.m. PDT",892,859,771,-121
SCL,"6/4/2024 1 a.m. PDT",820,794,568,-252
SCL,"6/4/2024 2 a.m. PDT",808,757,570,-238
SCL,"6/4/2024 3 a.m. PDT",780,738,528,-252
SCL,"6/4/2024 4 a.m. PDT",782,734,551,-231
SCL,"6/4/2024 5 a.m. PDT",805,753,553,-252
SCL,"6/4/2024 6 a.m. PDT",887,803,554,-333
SCL,"6/4/2024 7 a.m. PDT",953,905,815,-138
SCL,"6/4/2024 8 a.m. PDT",1045,996,899,-146
SCL,"6/4/2024 9 a.m. PDT",1078,1020,943,-135
SCL,"6/4/2024 10 a.m. PDT",1081,1023,773,-308
SCL,"6/4/2024 11 a.m. PDT",1074,1013,756,-318
SCL,"6/4/2024 12 p.m. PDT",1056,1006,695,-361
SCL,"6/4/2024 1 p.m. PDT",1052,1004,691,-361
SCL,"6/4/2024 2 p.m. PDT",1029,999,590,-439
SCL,"6/4/2024 3 p.m. PDT",1013,990,595,-418
SCL,"6/4/2024 4 p.m. PDT",985,988,595,-390
SCL,"6/4/2024 5 p.m. PDT",989,998,599,-390
SCL,"6/4/2024 6 p.m. PDT",1010,1009,627,-383
SCL,"6/4/2024 7 p.m. PDT",991,1000,742,-249
SCL,"6/4/2024 8 p.m. PDT",988,986,748,-240
SCL,"6/4/2024 9 p.m. PDT",983,972,845,-138
SCL,"6/4/2024 10 p.m. PDT",977,974,877,-100
SCL,"6/4/2024 11 p.m. PDT",918,929,658,-260
SCL,"6/5/2024 12 a.m. PDT",844,862,483,-361
SCL,"6/5/2024 1 a.m. PDT",786,790,435,-351
SCL,"6/5/2024 2 a.m. PDT",748,755,388,-360
SCL,"6/5/2024 3 a.m. PDT",725,738,526,-199
SCL,"6/5/2024 4 a.m. PDT",724,737,592,-132
SCL,"6/5/2024 5 a.m. PDT",745,763,624,-121
SCL,"6/5/2024 6 a.m. PDT",808,820,600,-208
SCL,"6/5/2024 7 a.m. PDT",917,925,781,-136
SCL,"6/5/2024 8 a.m. PDT",984,1014,831,-153
SCL,"6/5/2024 9 a.m. PDT",1005,1035,897,-108
SCL,"6/5/2024 10 a.m. PDT",1000,1032,897,-103
SCL,"6/5/2024 11 a.m. PDT",993,1027,817,-176
SCL,"6/5/2024 12 p.m. PDT",991,1025,870,-121
SCL,"6/5/2024 1 p.m. PDT",982,1024,869,-113
SCL,"6/5/2024 2 p.m. PDT",980,1020,729,-251
SCL,"6/5/2024 3 p.m. PDT",969,1014,716,-253
SCL,"6/5/2024 4 p.m. PDT",969,1014,714,-255
SCL,"6/5/2024 5 p.m. PDT",988,1025,810,-178
SCL,"6/5/2024 6 p.m. PDT",998,1038,843,-155
SCL,"6/5/2024 7 p.m. PDT",995,1021,965,-30
SCL,"6/5/2024 8 p.m. PDT",984,1003,1020,36
SCL,"6/5/2024 9 p.m. PDT",975,988,1064,89
SCL,"6/5/2024 10 p.m. PDT",965,982,872,-93
SCL,"6/5/2024 11 p.m. PDT",917,933,773,-144
SCL,"6/6/2024 12 a.m. PDT",834,863,724,-110
SCL,"6/6/2024 1 a.m. PDT",772,785,509,-263
SCL,"6/6/2024 2 a.m. PDT",736,742,446,-290
SCL,"6/6/2024 3 a.m. PDT",712,724,413,-299
SCL,"6/6/2024 4 a.m. PDT",714,721,390,-324
SCL,"6/6/2024 5 a.m. PDT",739,744,464,-275
SCL,"6/6/2024 6 a.m. PDT",795,800,568,-227
SCL,"6/6/2024 7 a.m. PDT",895,898,853,-42
SCL,"6/6/2024 8 a.m. PDT",973,983,903,-70
SCL,"6/6/2024 9 a.m. PDT",994,999,773,-221
SCL,"6/6/2024 10 a.m. PDT",1005,1007,729,-276
SCL,"6/6/2024 11 a.m. PDT",995,1007,724,-271
SCL,"6/6/2024 12 p.m. PDT",997,1008,748,-249
SCL,"6/6/2024 1 p.m. PDT",992,1010,837,-155
SCL,"6/6/2024 2 p.m. PDT",993,1010,835,-158
SCL,"6/6/2024 3 p.m. PDT",988,1008,839,-149
SCL,"6/6/2024 4 p.m. PDT",988,1012,870,-118
SCL,"6/6/2024 5 p.m. PDT",999,1027,799,-200
SCL,"6/6/2024 6 p.m. PDT",1015,1036,885,-130
SCL,"6/6/2024 7 p.m. PDT",1002,1010,959,-43
SCL,"6/6/2024 8 p.m. PDT",990,993,948,-42
SCL,"6/6/2024 9 p.m. PDT",980,972,931,-49
SCL,"6/6/2024 10 p.m. PDT",968,965,871,-97
SCL,"6/6/2024 11 p.m. PDT",913,919,641,-272
SCL,"6/7/2024 12 a.m. PDT",836,850,584,-252
SCL,"6/7/2024 1 a.m. PDT",777,789,539,-238
SCL,"6/7/2024 2 a.m. PDT",737,745,517,-220
SCL,"6/7/2024 3 a.m. PDT",710,722,550,-160
SCL,"6/7/2024 4 a.m. PDT",706,717,546,-160
SCL,"6/7/2024 5 a.m. PDT",723,735,596,-127
SCL,"6/7/2024 6 a.m. PDT",767,786,582,-185
SCL,"6/7/2024 7 a.m. PDT",862,876,728,-134
SCL,"6/7/2024 8 a.m. PDT",944,955,799,-145
SCL,"6/7/2024 9 a.m. PDT",990,993,781,-209
SCL,"6/7/2024 10 a.m. PDT",1015,1013,699,-316
SCL,"6/7/2024 11 a.m. PDT",1035,1023,717,-318
SCL,"6/7/2024 12 p.m. PDT",1034,1030,705,-329
SCL,"6/7/2024 1 p.m. PDT",1048,1035,742,-306
SCL,"6/7/2024 2 p.m. PDT",1055,1038,887,-168
SCL,"6/7/2024 3 p.m. PDT",1055,1040,947,-108
SCL,"6/7/2024 4 p.m. PDT",1063,1045,963,-100
SCL,"6/7/2024 5 p.m. PDT",1078,1055,933,-145
SCL,"6/7/2024 6 p.m. PDT",1083,1059,923,-160
SCL,"6/7/2024 7 p.m. PDT",1064,1023,1022,-42
SCL,"6/7/2024 8 p.m. PDT",1041,993,1063,22
SCL,"6/7/2024 9 p.m. PDT",1025,969,1013,-12
SCL,"6/7/2024 10 p.m. PDT",1005,951,974,-31
SCL,"6/7/2024 11 p.m. PDT",971,909,747,-224
SCL,"6/8/2024 12 a.m. PDT",896,850,718,-178
SCL,"6/8/2024 1 a.m. PDT",841,806,540,-301
SCL,"6/8/2024 2 a.m. PDT",795,762,520,-275
SCL,"6/8/2024 3 a.m. PDT",765,733,525,-240
SCL,"6/8/2024 4 a.m. PDT",748,718,501,-247
SCL,"6/8/2024 5 a.m. PDT",755,717,544,-211
SCL,"6/8/2024 6 a.m. PDT",755,724,529,-226
SCL,"6/8/2024 7 a.m. PDT",785,760,730,-55
SCL,"6/8/2024 8 a.m. PDT",847,815,739,-108
SCL,"6/8/2024 9 a.m. PDT",878,877,790,-88
SCL,"6/8/2024 10 a.m. PDT",951,916,837,-114
SCL,"6/8/2024 11 a.m. PDT",969,937,844,-125
SCL,"6/8/2024 12 p.m. PDT",999,946,899,-100
SCL,"6/8/2024 1 p.m. PDT",1007,951,886,-121
SCL,"6/8/2024 2 p.m. PDT",1016,950,891,-125
SCL,"6/8/2024 3 p.m. PDT",1003,945,900,-103
SCL,"6/8/2024 4 p.m. PDT",1001,955,887,-114
SCL,"6/8/2024 5 p.m. PDT",1018,972,1036,18
SCL,"6/8/2024 6 p.m. PDT",1028,979,908,-120
SCL,"6/8/2024 7 p.m. PDT",1049,976,793,-256
SCL,"6/8/2024 8 p.m. PDT",1036,963,971,-65
SCL,"6/8/2024 9 p.m. PDT",1027,948,1093,66
SCL,"6/8/2024 10 p.m. PDT",996,942,999,3
SCL,"6/8/2024 11 p.m. PDT",964,905,670,-294
SCL,"6/9/2024 12 a.m. PDT",892,853,633,-259
SCL,"6/9/2024 1 a.m. PDT",840,806,537,-303
SCL,"6/9/2024 2 a.m. PDT",796,754,538,-258
SCL,"6/9/2024 3 a.m. PDT",766,725,533,-233
SCL,"6/9/2024 4 a.m. PDT",754,710,533,-221
SCL,"6/9/2024 5 a.m. PDT",744,706,570,-174
SCL,"6/9/2024 6 a.m. PDT",707,707,567,-140
SCL,"6/9/2024 7 a.m. PDT",762,736,553,-209
SCL,"6/9/2024 8 a.m. PDT",816,786,577,-239
SCL,"6/9/2024 9 a.m. PDT",870,840,665,-205
SCL,"6/9/2024 10 a.m. PDT",914,886,766,-148
SCL,"6/9/2024 11 a.m. PDT",934,918,820,-114
SCL,"6/9/2024 12 p.m. PDT",951,931,777,-174
SCL,"6/9/2024 1 p.m. PDT",960,935,771,-189
SCL,"6/9/2024 2 p.m. PDT",967,941,791,-176
SCL,"6/9/2024 3 p.m. PDT",970,946,811,-159
SCL,"6/9/2024 4 p.m. PDT",979,954,974,-5
SCL,"6/9/2024 5 p.m. PDT",1021,974,999,-22
SCL,"6/9/2024 6 p.m. PDT",1048,1004,980,-68
SCL,"6/9/2024 7 p.m. PDT",1059,1007,956,-103
SCL,"6/9/2024 8 p.m. PDT",1052,997,930,-122
SCL,"6/9/2024 9 p.m. PDT",1027,983,960,-67
SCL,"6/9/2024 10 p.m. PDT",1020,975,916,-104
SCL,"6/9/2024 11 p.m. PDT",960,926,735,-225
SCL,"6/10/2024 12 a.m. PDT",877,854,719,-158
SCL,"6/10/2024 1 a.m. PDT",815,785,655,-160
SCL,"6/10/2024 2 a.m. PDT",774,742,733,-41
SCL,"6/10/2024 3 a.m. PDT",759,723,706,-53
SCL,"6/10/2024 4 a.m. PDT",757,720,784,27
SCL,"6/10/2024 5 a.m. PDT",773,734,786,13
SCL,"6/10/2024 6 a.m. PDT",809,776,585,-224
SCL,"6/10/2024 7 a.m. PDT",893,866,791,-102
SCL,"6/10/2024 8 a.m. PDT",987,942,905,-82
SCL,"6/10/2024 9 a.m. PDT",1026,968,791,-235
SCL,"6/10/2024 10 a.m. PDT",1033,980,811,-222
SCL,"6/10/2024 11 a.m. PDT",1058,984,817,-241
SCL,"6/10/2024 12 p.m. PDT",1057,989,769,-288
SCL,"6/10/2024 1 p.m. PDT",1055,994,771,-284
SCL,"6/10/2024 2 p.m. PDT",1033,993,755,-278
SCL,"6/10/2024 3 p.m. PDT",1017,993,749,-268
SCL,"6/10/2024 4 p.m. PDT",1034,1001,753,-281
SCL,"6/10/2024 5 p.m. PDT",1057,1019,848,-209
SCL,"6/10/2024 6 p.m. PDT",1072,1032,871,-201
SCL,"6/10/2024 7 p.m. PDT",1077,1015,1005,-72
SCL,"6/10/2024 8 p.m. PDT",1059,996,1016,-43
SCL,"6/10/2024 9 p.m. PDT",1032,980,1003,-29
SCL,"6/10/2024 10 p.m. PDT",1026,966,1015,-11
SCL,"6/10/2024 11 p.m. PDT",959,911,883,-76
SCL,"6/11/2024 12 a.m. PDT",886,832,746,-140
SCL,"6/11/2024 1 a.m. PDT",823,785,742,-81
SCL,"6/11/2024 2 a.m. PDT",776,745,623,-153
SCL,"6/11/2024 3 a.m. PDT",761,724,586,-175
SCL,"6/11/2024 4 a.m. PDT",756,719,566,-190
SCL,"6/11/2024 5 a.m. PDT",770,734,597,-173
SCL,"6/11/2024 6 a.m. PDT",803,780,680,-123
SCL,"6/11/2024 7 a.m. PDT",870,873,825,-45
SCL,"6/11/2024 8 a.m. PDT",948,959,992,44
SCL,"6/11/2024 9 a.m. PDT",989,994,825,-164
SCL,"6/11/2024 10 a.m. PDT",1004,1002,836,-168
SCL,"6/11/2024 11 a.m. PDT",999,1003,886,-113
SCL,"6/11/2024 12 p.m. PDT",998,1007,953,-45
SCL,"6/11/2024 1 p.m. PDT",1004,1012,960,-44
SCL,"6/11/2024 2 p.m. PDT",997,1011,900,-97
SCL,"6/11/2024 3 p.m. PDT",982,1008,853,-129
SCL,"6/11/2024 4 p.m. PDT",985,1009,816,-169
SCL,"6/11/2024 5 p.m. PDT",1000,1017,889,-111
SCL,"6/11/2024 6 p.m. PDT",1002,1022,915,-87
SCL,"6/11/2024 7 p.m. PDT",984,1006,1001,17
SCL,"6/11/2024 8 p.m. PDT",970,991,965,-5
SCL,"6/11/2024 9 p.m. PDT",962,976,938,-24
SCL,"6/11/2024 10 p.m. PDT",956,970,934,-22
SCL,"6/11/2024 11 p.m. PDT",893,919,770,-123
SCL,"6/12/2024 12 a.m. PDT",819,845,715,-104
SCL,"6/12/2024 1 a.m. PDT",763,766,740,-23
SCL,"6/12/2024 2 a.m. PDT",729,727,714,-15
SCL,"6/12/2024 3 a.m. PDT",711,708,701,-10
SCL,"6/12/2024 4 a.m. PDT",702,705,706,4
SCL,"6/12/2024 5 a.m. PDT",726,726,707,-19
SCL,"6/12/2024 6 a.m. PDT",772,783,701,-71
SCL,"6/12/2024 7 a.m. PDT",872,882,759,-113
SCL,"6/12/2024 8 a.m. PDT",954,971,869,-85
SCL,"6/12/2024 9 a.m. PDT",979,1004,894,-85
SCL,"6/12/2024 10 a.m. PDT",989,1002,822,-167
SCL,"6/12/2024 11 a.m. PDT",984,1002,804,-180
SCL,"6/12/2024 12 p.m. PDT",978,1003,851,-127
SCL,"6/12/2024 1 p.m. PDT",980,1004,928,-52
SCL,"6/12/2024 2 p.m. PDT",988,1002,890,-98
SCL,"6/12/2024 3 p.m. PDT",983,996,937,-46
SCL,"6/12/2024 4 p.m. PDT",969,999,914,-55
SCL,"6/12/2024 5 p.m. PDT",980,1007,925,-55
SCL,"6/12/2024 6 p.m. PDT",990,1022,958,-32
SCL,"6/12/2024 7 p.m. PDT",978,1002,986,8
SCL,"6/12/2024 8 p.m. PDT",969,985,1095,126
SCL,"6/12/2024 9 p.m. PDT",961,971,1041,80
SCL,"6/12/2024 10 p.m. PDT",947,965,1095,148
SCL,"6/12/2024 11 p.m. PDT",899,917,806,-93
SCL,"6/13/2024 12 a.m. PDT",824,849,753,-71
SCL,"6/13/2024 1 a.m. PDT",767,774,714,-53
SCL,"6/13/2024 2 a.m. PDT",733,735,807,74
SCL,"6/13/2024 3 a.m. PDT",710,718,828,118
SCL,"6/13/2024 4 a.m. PDT",706,715,774,68
SCL,"6/13/2024 5 a.m. PDT",728,737,749,21
SCL,"6/13/2024 6 a.m. PDT",774,794,805,31
SCL,"6/13/2024 7 a.m. PDT",876,893,899,23
SCL,"6/13/2024 8 a.m. PDT",952,973,947,-5
SCL,"6/13/2024 9 a.m. PDT",993,992,920,-73
SCL,"6/13/2024 10 a.m. PDT",996,994,899,-97
SCL,"6/13/2024 11 a.m. PDT",1000,992,899,-101
SCL,"6/13/2024 12 p.m. PDT",1000,990,857,-143
SCL,"6/13/2024 1 p.m. PDT",1006,988,852,-154
SCL,"6/13/2024 2 p.m. PDT",1003,987,848,-155
SCL,"6/13/2024 3 p.m. PDT",1008,984,840,-168
SCL,"6/13/2024 4 p.m. PDT",1001,986,846,-155
SCL,"6/13/2024 5 p.m. PDT",1002,998,859,-143
SCL,"6/13/2024 6 p.m. PDT",998,1011,1023,25
SCL,"6/13/2024 7 p.m. PDT",990,991,1049,59
SCL,"6/13/2024 8 p.m. PDT",968,973,1076,108
SCL,"6/13/2024 9 p.m. PDT",958,956,1027,69
SCL,"6/13/2024 10 p.m. PDT",949,950,980,31
SCL,"6/13/2024 11 p.m. PDT",906,906,861,-45
SCL,"6/14/2024 12 a.m. PDT",829,839,922,93
SCL,"6/14/2024 1 a.m. PDT",760,777,745,-15
SCL,"6/14/2024 2 a.m. PDT",721,732,734,13
SCL,"6/14/2024 3 a.m. PDT",705,713,700,-5
SCL,"6/14/2024 4 a.m. PDT",700,711,712,12
SCL,"6/14/2024 5 a.m. PDT",718,735,761,43
SCL,"6/14/2024 6 a.m. PDT",760,791,778,18
SCL,"6/14/2024 7 a.m. PDT",862,890,922,60
SCL,"6/14/2024 8 a.m. PDT",960,976,888,-72
SCL,"6/14/2024 9 a.m. PDT",988,1003,1108,120
SCL,"6/14/2024 10 a.m. PDT",1001,1011,1049,48
SCL,"6/14/2024 11 a.m. PDT",1018,1017,1042,24
SCL,"6/14/2024 12 p.m. PDT",1024,1016,1027,3
SCL,"6/14/2024 1 p.m. PDT",1043,1014,1040,-3
SCL,"6/14/2024 2 p.m. PDT",1060,1009,976,-84
SCL,"6/14/2024 3 p.m. PDT",1046,1000,967,-79
SCL,"6/14/2024 4 p.m. PDT",1018,997,1043,25
SCL,"6/14/2024 5 p.m. PDT",985,1003,1055,70
SCL,"6/14/2024 6 p.m. PDT",989,1005,1049,60
SCL,"6/14/2024 7 p.m. PDT",966,986,1066,100
SCL,"6/14/2024 8 p.m. PDT",948,964,1111,163
SCL,"6/14/2024 9 p.m. PDT",924,946,1094,170
SCL,"6/14/2024 10 p.m. PDT",922,939,1057,135
SCL,"6/14/2024 11 p.m. PDT",884,901,999,115
SCL,"6/15/2024 12 a.m. PDT",863,846,937,74
SCL,"6/15/2024 1 a.m. PDT",816,783,793,-23
SCL,"6/15/2024 2 a.m. PDT",792,743,821,29
SCL,"6/15/2024 3 a.m. PDT",763,721,800,37
SCL,"6/15/2024 4 a.m. PDT",762,712,791,29
SCL,"6/15/2024 5 a.m. PDT",760,721,788,28
SCL,"6/15/2024 6 a.m. PDT",774,741,790,16
SCL,"6/15/2024 7 a.m. PDT",818,786,979,161
SCL,"6/15/2024 8 a.m. PDT",862,841,960,98
SCL,"6/15/2024 9 a.m. PDT",912,897,911,-1
SCL,"6/15/2024 10 a.m. PDT",955,929,995,40
SCL,"6/15/2024 11 a.m. PDT",965,945,992,27
SCL,"6/15/2024 12 p.m. PDT",970,949,1000,30
SCL,"6/15/2024 1 p.m. PDT",938,939,1005,67
SCL,"6/15/2024 2 p.m. PDT",911,929,952,41
SCL,"6/15/2024 3 p.m. PDT",911,918,961,50
SCL,"6/15/2024 4 p.m. PDT",891,913,917,26
SCL,"6/15/2024 5 p.m. PDT",917,922,949,32
SCL,"6/15/2024 6 p.m. PDT",915,931,974,59
SCL,"6/15/2024 7 p.m. PDT",925,936,984,59
SCL,"6/15/2024 8 p.m. PDT",916,931,953,37
SCL,"6/15/2024 9 p.m. PDT",916,939,1011,95
SCL,"6/15/2024 10 p.m. PDT",925,947,1053,128
SCL,"6/15/2024 11 p.m. PDT",896,915,900,4
SCL,"6/16/2024 12 a.m. PDT",836,865,874,38
SCL,"6/16/2024 1 a.m. PDT",802,795,912,110
SCL,"6/16/2024 2 a.m. PDT",780,754,837,57
SCL,"6/16/2024 3 a.m. PDT",744,734,821,77
SCL,"6/16/2024 4 a.m. PDT",725,725,858,133
SCL,"6/16/2024 5 a.m. PDT",721,730,858,137
SCL,"6/16/2024 6 a.m. PDT",738,743,877,139
SCL,"6/16/2024 7 a.m. PDT",770,780,805,35
SCL,"6/16/2024 8 a.m. PDT",812,831,816,4
SCL,"6/16/2024 9 a.m. PDT",860,878,834,-26
SCL,"6/16/2024 10 a.m. PDT",938,907,895,-43
SCL,"6/16/2024 11 a.m. PDT",940,920,897,-43
SCL,"6/16/2024 12 p.m. PDT",966,923,891,-75
SCL,"6/16/2024 1 p.m. PDT",960,916,877,-83
SCL,"6/16/2024 2 p.m. PDT",927,913,832,-95
SCL,"6/16/2024 3 p.m. PDT",922,907,955,33
SCL,"6/16/2024 4 p.m. PDT",918,904,927,9
SCL,"6/16/2024 5 p.m. PDT",934,920,946,12
SCL,"6/16/2024 6 p.m. PDT",956,944,992,36
SCL,"6/16/2024 7 p.m. PDT",978,957,1064,86
SCL,"6/16/2024 8 p.m. PDT",980,955,1071,91
SCL,"6/16/2024 9 p.m. PDT",980,953,1012,32
SCL,"6/16/2024 10 p.m. PDT",987,956,988,1
SCL,"6/16/2024 11 p.m. PDT",950,917,1028,78
SCL,"6/17/2024 12 a.m. PDT",860,854,992,132
SCL,"6/17/2024 1 a.m. PDT",811,781,944,133
SCL,"6/17/2024 2 a.m. PDT",783,742,861,78
SCL,"6/17/2024 3 a.m. PDT",761,727,827,66
SCL,"6/17/2024 4 a.m. PDT",757,729,812,55
SCL,"6/17/2024 5 a.m. PDT",789,754,947,158
SCL,"6/17/2024 6 a.m. PDT",840,810,947,107
SCL,"6/17/2024 7 a.m. PDT",945,910,924,-21
SCL,"6/17/2024 8 a.m. PDT",1036,994,1016,-20
SCL,"6/17/2024 9 a.m. PDT",1065,1028,1024,-41
SCL,"6/17/2024 10 a.m. PDT",1075,1034,975,-100
SCL,"6/17/2024 11 a.m. PDT",1089,1030,985,-104
SCL,"6/17/2024 12 p.m. PDT",1086,1027,943,-143
SCL,"6/17/2024 1 p.m. PDT",1081,1028,904,-177
SCL,"6/17/2024 2 p.m. PDT",1078,1020,860,-218
SCL,"6/17/2024 3 p.m. PDT",1062,1012,898,-164
SCL,"6/17/2024 4 p.m. PDT",1056,1008,831,-225
SCL,"6/17/2024 5 p.m. PDT",1055,1018,816,-239
SCL,"6/17/2024 6 p.m. PDT",1057,1029,903,-154
SCL,"6/17/2024 7 p.m. PDT",1068,1018,1025,-43
SCL,"6/17/2024 8 p.m. PDT",1057,1006,976,-81
SCL,"6/17/2024 9 p.m. PDT",1040,992,943,-97
SCL,"6/17/2024 10 p.m. PDT",1019,982,988,-31
SCL,"6/17/2024 11 p.m. PDT",957,932,924,-33
SCL,"6/18/2024 12 a.m. PDT",886,858,912,26
SCL,"6/18/2024 1 a.m. PDT",814,778,913,99
SCL,"6/18/2024 2 a.m. PDT",773,751,854,81
SCL,"6/18/2024 3 a.m. PDT",764,732,836,72
SCL,"6/18/2024 4 a.m. PDT",767,730,839,72
SCL,"6/18/2024 5 a.m. PDT",785,751,867,82
SCL,"6/18/2024 6 a.m. PDT",804,803,901,97
SCL,"6/18/2024 7 a.m. PDT",901,903,902,1
SCL,"6/18/2024 8 a.m. PDT",981,993,1000,19
SCL,"6/18/2024 9 a.m. PDT",1014,1016,868,-146
SCL,"6/18/2024 10 a.m. PDT",1012,1018,784,-228
SCL,"6/18/2024 11 a.m. PDT",1001,1010,838,-163
SCL,"6/18/2024 12 p.m. PDT",998,1010,962,-36
SCL,"6/18/2024 1 p.m. PDT",1022,1012,927,-95
SCL,"6/18/2024 2 p.m. PDT",997,1008,867,-130
SCL,"6/18/2024 3 p.m. PDT",992,1000,923,-69
SCL,"6/18/2024 4 p.m. PDT",977,1002,910,-67
SCL,"6/18/2024 5 p.m. PDT",981,1016,921,-60
SCL,"6/18/2024 6 p.m. PDT",1002,1029,1056,54
SCL,"6/18/2024 7 p.m. PDT",1000,1019,1193,193
SCL,"6/18/2024 8 p.m. PDT",987,998,1230,243
SCL,"6/18/2024 9 p.m. PDT",970,978,1157,187
SCL,"6/18/2024 10 p.m. PDT",962,968,1068,106
SCL,"6/18/2024 11 p.m. PDT",916,918,954,38
SCL,"6/19/2024 12 a.m. PDT",822,845,925,103
SCL,"6/19/2024 1 a.m. PDT",767,781,534,-233
SCL,"6/19/2024 2 a.m. PDT",732,728,512,-220
SCL,"6/19/2024 3 a.m. PDT",704,710,498,-206
SCL,"6/19/2024 4 a.m. PDT",700,708,506,-194
SCL,"6/19/2024 5 a.m. PDT",716,735,506,-210
SCL,"6/19/2024 6 a.m. PDT",758,794,576,-182
SCL,"6/19/2024 7 a.m. PDT",829,894,911,82
SCL,"6/19/2024 8 a.m. PDT",897,980,994,97
SCL,"6/19/2024 9 a.m. PDT",956,1010,815,-141
SCL,"6/19/2024 10 a.m. PDT",964,1018,787,-177
SCL,"6/19/2024 11 a.m. PDT",977,1020,790,-187
SCL,"6/19/2024 12 p.m. PDT",998,1025,696,-302
SCL,"6/19/2024 1 p.m. PDT",999,1031,707,-292
SCL,"6/19/2024 2 p.m. PDT",1001,1035,799,-202
SCL,"6/19/2024 3 p.m. PDT",1000,1039,758,-242
SCL,"6/19/2024 4 p.m. PDT",1004,1046,705,-299
SCL,"6/19/2024 5 p.m. PDT",1034,1059,773,-261
SCL,"6/19/2024 6 p.m. PDT",1060,1070,845,-215
SCL,"6/19/2024 7 p.m. PDT",1048,1042,1113,65
SCL,"6/19/2024 8 p.m. PDT",1024,1019,1189,164
SCL,"6/19/2024 9 p.m. PDT",1009,1002,1142,133
SCL,"6/19/2024 10 p.m. PDT",989,987,1105,116
SCL,"6/19/2024 11 p.m. PDT",946,932,795,-151
SCL,"6/20/2024 12 a.m. PDT",850,855,711,-139
SCL,"6/20/2024 1 a.m. PDT",780,809,558,-222
SCL,"6/20/2024 2 a.m. PDT",734,745,564,-170
SCL,"6/20/2024 3 a.m. PDT",710,721,542,-168
SCL,"6/20/2024 4 a.m. PDT",703,714,535,-168
SCL,"6/20/2024 5 a.m. PDT",707,733,546,-161
SCL,"6/20/2024 6 a.m. PDT",754,779,545,-209
SCL,"6/20/2024 7 a.m. PDT",846,875,834,-12
SCL,"6/20/2024 8 a.m. PDT",939,966,1005,66
SCL,"6/20/2024 9 a.m. PDT",993,1008,1017,24
SCL,"6/20/2024 10 a.m. PDT",1022,1026,970,-52
SCL,"6/20/2024 11 a.m. PDT",1046,1036,959,-87
SCL,"6/20/2024 12 p.m. PDT",1053,1049,966,-87
SCL,"6/20/2024 1 p.m. PDT",1071,1061,977,-94
SCL,"6/20/2024 2 p.m. PDT",1071,1072,838,-233
SCL,"6/20/2024 3 p.m. PDT",1074,1080,829,-245
SCL,"6/20/2024 4 p.m. PDT",1085,1090,835,-250
SCL,"6/20/2024 5 p.m. PDT",1101,1108,821,-280
SCL,"6/20/2024 6 p.m. PDT",1111,1116,837,-274
SCL,"6/20/2024 7 p.m. PDT",1095,1083,913,-182
SCL,"6/20/2024 8 p.m. PDT",1076,1048,941,-135
SCL,"6/20/2024 9 p.m. PDT",1064,1026,992,-72
SCL,"6/20/2024 10 p.m. PDT",1030,1015,971,-59
SCL,"6/20/2024 11 p.m. PDT",980,962,619,-361
SCL,"6/21/2024 12 a.m. PDT",894,882,573,-321
SCL,"6/21/2024 1 a.m. PDT",814,827,563,-251
SCL,"6/21/2024 2 a.m. PDT",766,783,546,-220
SCL,"6/21/2024 3 a.m. PDT",735,754,558,-177
SCL,"6/21/2024 4 a.m. PDT",726,744,541,-185
SCL,"6/21/2024 5 a.m. PDT",729,759,508,-221
SCL,"6/21/2024 6 a.m. PDT",765,798,505,-260
SCL,"6/21/2024 7 a.m. PDT",852,885,715,-137
SCL,"6/21/2024 8 a.m. PDT",953,975,744,-209
SCL,"6/21/2024 9 a.m. PDT",1017,1023,868,-149
SCL,"6/21/2024 10 a.m. PDT",1056,1053,832,-224
SCL,"6/21/2024 11 a.m. PDT",1089,1075,815,-274
SCL,"6/21/2024 12 p.m. PDT",1136,1093,794,-342
SCL,"6/21/2024 1 p.m. PDT",1142,1107,808,-334
SCL,"6/21/2024 2 p.m. PDT",1161,1121,779,-382
SCL,"6/21/2024 3 p.m. PDT",1180,1130,823,-357
SCL,"6/21/2024 4 p.m. PDT",1191,1142,890,-301
SCL,"6/21/2024 5 p.m. PDT",1193,1156,797,-396
SCL,"6/21/2024 6 p.m. PDT",1208,1149,848,-360
SCL,"6/21/2024 7 p.m. PDT",1167,1112,1091,-76
SCL,"6/21/2024 8 p.m. PDT",1130,1073,1137,7
SCL,"6/21/2024 9 p.m. PDT",1092,1040,1089,-3
SCL,"6/21/2024 10 p.m. PDT",1081,1022,975,-106
SCL,"6/21/2024 11 p.m. PDT",1023,976,818,-205
SCL,"6/22/2024 12 a.m. PDT",934,903,778,-157
SCL,"6/22/2024 1 a.m. PDT",881,833,629,-252
SCL,"6/22/2024 2 a.m. PDT",832,787,509,-323
SCL,"6/22/2024 3 a.m. PDT",792,755,500,-292
SCL,"6/22/2024 4 a.m. PDT",774,736,491,-283
SCL,"6/22/2024 5 a.m. PDT",767,733,573,-194
SCL,"6/22/2024 6 a.m. PDT",767,735,614,-153
SCL,"6/22/2024 7 a.m. PDT",783,769,677,-106
SCL,"6/22/2024 8 a.m. PDT",827,827,698,-129
SCL,"6/22/2024 9 a.m. PDT",877,898,741,-136
SCL,"6/22/2024 10 a.m. PDT",908,939,768,-140
SCL,"6/22/2024 11 a.m. PDT",957,963,789,-168
SCL,"6/22/2024 12 p.m. PDT",969,980,830,-139
SCL,"6/22/2024 1 p.m. PDT",964,992,826,-138
SCL,"6/22/2024 2 p.m. PDT",975,991,805,-170
SCL,"6/22/2024 3 p.m. PDT",931,983,814,-117
SCL,"6/22/2024 4 p.m. PDT",939,990,820,-119
SCL,"6/22/2024 5 p.m. PDT",986,1008,810,-176
SCL,"6/22/2024 6 p.m. PDT",1025,1012,928,-97
SCL,"6/22/2024 7 p.m. PDT",1013,1010,737,-276
SCL,"6/22/2024 8 p.m. PDT",1011,996,908,-103
SCL,"6/22/2024 9 p.m. PDT",989,976,959,-30
SCL,"6/22/2024 10 p.m. PDT",977,967,975,-2
SCL,"6/22/2024 11 p.m. PDT",949,934,676,-273
SCL,"6/23/2024 12 a.m. PDT",894,880,711,-183
SCL,"6/23/2024 1 a.m. PDT",832,796,587,-245
SCL,"6/23/2024 2 a.m. PDT",787,755,584,-203
SCL,"6/23/2024 3 a.m. PDT",770,727,578,-192
SCL,"6/23/2024 4 a.m. PDT",745,711,592,-153
SCL,"6/23/2024 5 a.m. PDT",737,705,578,-159
SCL,"6/23/2024 6 a.m. PDT",745,706,586,-159
SCL,"6/23/2024 7 a.m. PDT",748,732,578,-170
SCL,"6/23/2024 8 a.m. PDT",801,778,574,-227
SCL,"6/23/2024 9 a.m. PDT",844,830,674,-170
SCL,"6/23/2024 10 a.m. PDT",888,873,712,-176
SCL,"6/23/2024 11 a.m. PDT",912,899,743,-169
SCL,"6/23/2024 12 p.m. PDT",902,912,865,-37
SCL,"6/23/2024 1 p.m. PDT",940,918,823,-117
SCL,"6/23/2024 2 p.m. PDT",960,919,774,-186
SCL,"6/23/2024 3 p.m. PDT",947,919,764,-183
SCL,"6/23/2024 4 p.m. PDT",956,918,678,-278
SCL,"6/23/2024 5 p.m. PDT",976,933,687,-289
SCL,"6/23/2024 6 p.m. PDT",983,956,719,-264
SCL,"6/23/2024 7 p.m. PDT",1006,964,717,-289
SCL,"6/23/2024 8 p.m. PDT",1005,956,747,-258
SCL,"6/23/2024 9 p.m. PDT",993,953,871,-122
SCL,"6/23/2024 10 p.m. PDT",993,950,851,-142
SCL,"6/23/2024 11 p.m. PDT",937,906,816,-121
SCL,"6/24/2024 12 a.m. PDT",872,834,741,-131
SCL,"6/24/2024 1 a.m. PDT",798,769,666,-132
SCL,"6/24/2024 2 a.m. PDT",773,731,637,-136
SCL,"6/24/2024 3 a.m. PDT",752,714,645,-107
SCL,"6/24/2024 4 a.m. PDT",749,710,643,-106
SCL,"6/24/2024 5 a.m. PDT",761,724,615,-146
SCL,"6/24/2024 6 a.m. PDT",802,767,648,-154
SCL,"6/24/2024 7 a.m. PDT",842,855,823,-19
SCL,"6/24/2024 8 a.m. PDT",917,928,883,-34
SCL,"6/24/2024 9 a.m. PDT",968,962,838,-130
SCL,"6/24/2024 10 a.m. PDT",992,976,860,-132
SCL,"6/24/2024 11 a.m. PDT",1003,982,911,-92
SCL,"6/24/2024 12 p.m. PDT",1002,989,827,-175
SCL,"6/24/2024 1 p.m. PDT",1005,994,766,-239
SCL,"6/24/2024 2 p.m. PDT",1009,992,744,-265
SCL,"6/24/2024 3 p.m. PDT",1012,987,714,-298
SCL,"6/24/2024 4 p.m. PDT",1030,994,680,-350
SCL,"6/24/2024 5 p.m. PDT",1013,1009,685,-328
SCL,"6/24/2024 6 p.m. PDT",1041,1022,848,-193
SCL,"6/24/2024 7 p.m. PDT",1039,1004,890,-149
SCL,"6/24/2024 8 p.m. PDT",1005,984,903,-102
SCL,"6/24/2024 9 p.m. PDT",1000,968,897,-103
SCL,"6/24/2024 10 p.m. PDT",974,952,807,-167
SCL,"6/24/2024 11 p.m. PDT",924,902,427,-497
SCL,"6/25/2024 12 a.m. PDT",834,829,370,-464
SCL,"6/25/2024 1 a.m. PDT",772,801,618,-154
SCL,"6/25/2024 2 a.m. PDT",734,744,475,-259
SCL,"6/25/2024 3 a.m. PDT",708,723,469,-239
SCL,"6/25/2024 4 a.m. PDT",698,718,465,-233
SCL,"6/25/2024 5 a.m. PDT",714,737,508,-206
SCL,"6/25/2024 6 a.m. PDT",750,788,526,-224
SCL,"6/25/2024 7 a.m. PDT",837,880,715,-122
SCL,"6/25/2024 8 a.m. PDT",931,967,757,-174
SCL,"6/25/2024 9 a.m. PDT",968,1004,813,-155
SCL,"6/25/2024 10 a.m. PDT",988,1015,756,-232
SCL,"6/25/2024 11 a.m. PDT",999,1016,746,-253
SCL,"6/25/2024 12 p.m. PDT",1027,1022,738,-289
SCL,"6/25/2024 1 p.m. PDT",1030,1031,782,-248
SCL,"6/25/2024 2 p.m. PDT",1031,1036,832,-199
SCL,"6/25/2024 3 p.m. PDT",1043,1038,758,-285
SCL,"6/25/2024 4 p.m. PDT",1049,1044,689,-360
SCL,"6/25/2024 5 p.m. PDT",1075,1059,832,-243
SCL,"6/25/2024 6 p.m. PDT",1089,1077,910,-179
SCL,"6/25/2024 7 p.m. PDT",1080,1049,917,-163
SCL,"6/25/2024 8 p.m. PDT",1051,1023,952,-99
SCL,"6/25/2024 9 p.m. PDT",1035,1008,911,-124
SCL,"6/25/2024 10 p.m. PDT",1004,997,888,-116
SCL,"6/25/2024 11 p.m. PDT",948,938,724,-224
SCL,"6/26/2024 12 a.m. PDT",863,856,548,-315
SCL,"6/26/2024 1 a.m. PDT",794,797,517,-277
SCL,"6/26/2024 2 a.m. PDT",747,767,531,-216
SCL,"6/26/2024 3 a.m. PDT",718,740,495,-223
SCL,"6/26/2024 4 a.m. PDT",708,730,496,-212
SCL,"6/26/2024 5 a.m. PDT",718,743,505,-213
SCL,"6/26/2024 6 a.m. PDT",747,784,508,-239
SCL,"6/26/2024 7 a.m. PDT",837,870,669,-168
SCL,"6/26/2024 8 a.m. PDT",906,954,703,-203
SCL,"6/26/2024 9 a.m. PDT",956,992,715,-241
SCL,"6/26/2024 10 a.m. PDT",972,1003,709,-263
SCL,"6/26/2024 11 a.m. PDT",998,1006,714,-284
SCL,"6/26/2024 12 p.m. PDT",1007,1012,697,-310
SCL,"6/26/2024 1 p.m. PDT",1006,1018,697,-309
SCL,"6/26/2024 2 p.m. PDT",1019,1023,701,-318
SCL,"6/26/2024 3 p.m. PDT",1018,1028,680,-338
SCL,"6/26/2024 4 p.m. PDT",1013,1028,676,-337
SCL,"6/26/2024 5 p.m. PDT",1005,1030,672,-333
SCL,"6/26/2024 6 p.m. PDT",1016,1033,673,-343
SCL,"6/26/2024 7 p.m. PDT",983,1011,679,-304
SCL,"6/26/2024 8 p.m. PDT",975,992,683,-292
SCL,"6/26/2024 9 p.m. PDT",970,977,673,-297
SCL,"6/26/2024 10 p.m. PDT",958,972,675,-283
SCL,"6/26/2024 11 p.m. PDT",894,924,509,-385
SCL,"6/27/2024 12 a.m. PDT",825,848,504,-321
SCL,"6/27/2024 1 a.m. PDT",765,767,371,-394
SCL,"6/27/2024 2 a.m. PDT",728,728,400,-328
SCL,"6/27/2024 3 a.m. PDT",705,708,370,-335
SCL,"6/27/2024 4 a.m. PDT",704,702,370,-334
SCL,"6/27/2024 5 a.m. PDT",710,718,412,-298
SCL,"6/27/2024 6 a.m. PDT",758,765,427,-331
SCL,"6/27/2024 7 a.m. PDT",837,859,666,-171
SCL,"6/27/2024 8 a.m. PDT",932,948,677,-255
SCL,"6/27/2024 9 a.m. PDT",969,988,674,-295
SCL,"6/27/2024 10 a.m. PDT",1003,1001,675,-328
SCL,"6/27/2024 11 a.m. PDT",1039,1005,597,-442
SCL,"6/27/2024 12 p.m. PDT",1045,1011,585,-460
SCL,"6/27/2024 1 p.m. PDT",1033,1014,549,-484
SCL,"6/27/2024 2 p.m. PDT",1040,1012,543,-497
SCL,"6/27/2024 3 p.m. PDT",1010,1007,579,-431
SCL,"6/27/2024 4 p.m. PDT",1026,1007,583,-443
SCL,"6/27/2024 5 p.m. PDT",1043,1013,689,-354
SCL,"6/27/2024 6 p.m. PDT",1053,1019,754,-299
SCL,"6/27/2024 7 p.m. PDT",1057,1007,760,-297
SCL,"6/27/2024 8 p.m. PDT",1014,991,759,-255
SCL,"6/27/2024 9 p.m. PDT",1028,978,781,-247
SCL,"6/27/2024 10 p.m. PDT",998,973,739,-259
SCL,"6/27/2024 11 p.m. PDT",955,926,437,-518
SCL,"6/28/2024 12 a.m. PDT",882,851,377,-505
SCL,"6/28/2024 1 a.m. PDT",824,798,369,-455
SCL,"6/28/2024 2 a.m. PDT",787,741,307,-480
SCL,"6/28/2024 3 a.m. PDT",771,720,315,-456
SCL,"6/28/2024 4 a.m. PDT",755,713,373,-382
SCL,"6/28/2024 5 a.m. PDT",775,726,404,-371
SCL,"6/28/2024 6 a.m. PDT",816,772,417,-399
SCL,"6/28/2024 7 a.m. PDT",898,861,580,-318
SCL,"6/28/2024 8 a.m. PDT",983,944,676,-307
SCL,"6/28/2024 9 a.m. PDT",1020,985,719,-301
SCL,"6/28/2024 10 a.m. PDT",1036,1005,750,-286
SCL,"6/28/2024 11 a.m. PDT",1043,1014,701,-342
SCL,"6/28/2024 12 p.m. PDT",1053,1019,690,-363
SCL,"6/28/2024 1 p.m. PDT",1048,1021,685,-363
SCL,"6/28/2024 2 p.m. PDT",1052,1024,679,-373
SCL,"6/28/2024 3 p.m. PDT",1043,1024,677,-366
SCL,"6/28/2024 4 p.m. PDT",1054,1027,700,-354
SCL,"6/28/2024 5 p.m. PDT",1050,1037,686,-364
SCL,"6/28/2024 6 p.m. PDT",1068,1046,695,-373
SCL,"6/28/2024 7 p.m. PDT",1033,1012,798,-235
SCL,"6/28/2024 8 p.m. PDT",1011,985,926,-85
SCL,"6/28/2024 9 p.m. PDT",995,959,961,-34
SCL,"6/28/2024 10 p.m. PDT",992,949,907,-85
SCL,"6/28/2024 11 p.m. PDT",958,902,607,-351
SCL,"6/29/2024 12 a.m. PDT",893,840,539,-354
SCL,"6/29/2024 1 a.m. PDT",834,809,552,-282
SCL,"6/29/2024 2 a.m. PDT",788,748,462,-326
SCL,"6/29/2024 3 a.m. PDT",764,722,416,-348
SCL,"6/29/2024 4 a.m. PDT",753,707,373,-380
SCL,"6/29/2024 5 a.m. PDT",749,707,373,-376
SCL,"6/29/2024 6 a.m. PDT",758,716,407,-351
SCL,"6/29/2024 7 a.m. PDT",784,751,600,-184
SCL,"6/29/2024 8 a.m. PDT",832,805,681,-151
SCL,"6/29/2024 9 a.m. PDT",870,861,721,-149
SCL,"6/29/2024 10 a.m. PDT",928,902,686,-242
SCL,"6/29/2024 11 a.m. PDT",976,921,595,-381
SCL,"6/29/2024 12 p.m. PDT",989,930,605,-384
SCL,"6/29/2024 1 p.m. PDT",999,932,616,-383
SCL,"6/29/2024 2 p.m. PDT",1004,927,608,-396
SCL,"6/29/2024 3 p.m. PDT",989,918,688,-301
SCL,"6/29/2024 4 p.m. PDT",991,918,700,-291
SCL,"6/29/2024 5 p.m. PDT",986,931,721,-265
SCL,"6/29/2024 6 p.m. PDT",995,939,726,-269
SCL,"6/29/2024 7 p.m. PDT",993,942,856,-137
SCL,"6/29/2024 8 p.m. PDT",976,938,879,-97
SCL,"6/29/2024 9 p.m. PDT",966,925,823,-143
SCL,"6/29/2024 10 p.m. PDT",948,924,748,-200
SCL,"6/29/2024 11 p.m. PDT",919,892,550,-369
SCL,"6/30/2024 12 a.m. PDT",876,838,565,-311
SCL,"6/30/2024 1 a.m. PDT",830,772,461,-369
SCL,"6/30/2024 2 a.m. PDT",805,743,427,-378
SCL,"6/30/2024 3 a.m. PDT",752,716,448,-304
SCL,"6/30/2024 4 a.m. PDT",744,701,411,-333
SCL,"6/30/2024 5 a.m. PDT",732,700,404,-328
SCL,"6/30/2024 6 a.m. PDT",756,704,407,-349
SCL,"6/30/2024 7 a.m. PDT",763,736,534,-229
SCL,"6/30/2024 8 a.m. PDT",812,789,526,-286
SCL,"6/30/2024 9 a.m. PDT",863,846,546,-317
SCL,"6/30/2024 10 a.m. PDT",919,892,560,-359
SCL,"6/30/2024 11 a.m. PDT",944,919,583,-361
SCL,"6/30/2024 12 p.m. PDT",966,933,679,-287
SCL,"6/30/2024 1 p.m. PDT",970,938,685,-285
SCL,"6/30/2024 2 p.m. PDT",981,942,692,-289
SCL,"6/30/2024 3 p.m. PDT",982,944,699,-283
SCL,"6/30/2024 4 p.m. PDT",974,947,692,-282
SCL,"6/30/2024 5 p.m. PDT",1013,968,679,-334
SCL,"6/30/2024 6 p.m. PDT",1037,996,726,-311
SCL,"6/30/2024 7 p.m. PDT",1034,1011,849,-185
SCL,"6/30/2024 8 p.m. PDT",1031,1005,979,-52
SCL,"6/30/2024 9 p.m. PDT",1010,994,971,-39
SCL,"6/30/2024 10 p.m. PDT",1006,988,874,-132
SCL,"6/30/2024 11 p.m. PDT",966,934,710,-256